данность: данность
бесплатный: Бесплатные бесплатную Бесплатное бесплатная бесплатна бесплатный бесплатных бесплатному бесплатное бесплатного
гарантировать: гарантированная гарантировано гарантированную гарантирует
облегчать: Облегчаем
разнос: Разнос
вещь: вещи вещей вещах Вещи вещь вещам
виноватый: виноваты виноват
всегда: всегда Всегда
базовый: базовым базово базового базовом базовой базовых базовый базовая базовую базовые
указывать: Указывать Указываем
активный: активной активном активнее активные активного активными Активнее Активная активному активным активный активны активных
естественно: Естественно естественно
внешне: внешне Внешне
решение: Решение
друг: друга друзья другу друг друзей друзьям друзьями другом
китайский: Китайское Китайская
жёсткий: Жесткие жесткий жесткого Жесткий жесткие жестких жестким
доказательство: доказательств доказательствах доказательство
испания: Испания Испании Испанию
конкуренция: Конкуренция
аттракцион: аттракцион аттракционы
важность: важности важность
читать: Читайте Читая Читать
десктоп: десктопе десктоп десктопа десктопами
драма: драмы
еда: еда еду
вид: виды видом видах вида видам видов виде Виды виду вид
аналитик: аналитике аналитику аналитики аналитик
блеск: блеск
этот: Этот Эта Эти Эту ЭТОМУ
удалой: Удал
единственный: единственного единственной единственным единственные Единственное единственный Единственный единственное
бонус: Бонусом бонус Бонус бонусы
аська: аськи аська
я: Меня Я Мне
аппаратный: аппаратных Аппаратное аппаратные аппаратная аппаратно аппаратный аппаратного аппаратное аппаратную
местоположение: Местоположение
безопасность: безопасности безопасность
ассертивность: ассертивность
вых: вых
впору: впору
анонимность: анонимность
автор: автора автору Автору автором авторы автор авторам Автор авторами авторов
детально: детально
марс: Марс
действие: действиях действия действии действием действию действие действий Действие
единственность: единственность
найти: Найти Нашел Найдите Найденная Найди
вниз: вниз
дружелюбный: дружелюбным
оцифровка: Оцифровка
гипнотехник: гипнотехники
нч: НЧ
анастасия: Анастасия
блудный: блудные
быть: будь будешь будем будете быть Была Суть Были Быть было Было была Будет будучи Был Е был были будьте будет буду Будем будут е
выписывать: выписываем
выгодно: выгодно
эфир: Эфир
дурь: дурь дури
дух: духом духи дух духе
слот: Слот
англоязычный: англоязычное
галка: галки
чтобы: Чтобы
внеземной: внеземного
вызов: вызовы вызова вызовов вызов
стенд: Стенды
дисковод: дисковода
энергетический: Энергетический
кроа: Кроа
дальнейший: дальнейшим дальнейшей дальнейшие дальнейшего дальнейшем дальнейшему дальнейшая
гнать: гнать
весь: всей Весь весь всех всеми всему всю Всеми Всем вся Всего Всех всем Вся всего Всю
банально: банально
входной: входной входного входные Входной входных
стоить: Стоило Стоит
пандемия: Пандемия
весёлый: веселее веселой веселого
идеальный: Идеальный
делисьдажа: делисьДаже
видно: видно Видно
ого: Ого
тем: Тем
механика: Механика
из: Из
выпаивать: выпаивать
видеть: вижу видеть видим Видим видишь видели видя Видишь видел видите Видя видят видит Видел
там: Там
волна: волнами волнах волну волн волны волна волне
гиктаймс: Гиктаймс
год: Год Годами годами годов года год годам годах годы году Лет годом
дождаться: дождаться
добавиться: Добавился добавились добавилось добавилась
адаптер: адаптер адаптера адаптеры адаптером
очередной: Очередная
деться: денется
деловой: деловой
райсся: Райсси
выводаподводить: выводаПодводя
дача: даче дачу
аист: аиста аист
видеопамять: видеопамяти
блок: блок блоком блоков блоками блока блоки блокам блоке
ангел: ангелом ангел ангелы ангелов
токен: Токены Токен
райгородский: Райгородский
компания: Компаний Компания Компании
админить: админить
близость: близость близости
бы: бы
руфус: Руфусом
безопасный: безопасные безопасную безопаснее безопасного безопасным безопасное безопасной
день: дня день дней днями днем дни дне днях дням
водка: водкой водка водки водку Водка
жуткий: жуткое жуткая
один: Одни Одной Один Одно Одна ОДИН ОДНОЙ Одним
приложение: Приложению Приложение Приложения
попробовать: Попробуем Попробуй Попробуйте Попробовать
двоичный: двоичный
создавать: Создает Создаем
глодать: гложет
акцент: акценты акцент
кения: Кении
аудио: Аудио аудио
вестинг: вестинг
облачный: Облачные Облачная Облачное
вывод: вывод Выводы выводы Вывод выводу вывода выводами выводах выводе
доказательный: доказательную доказательных доказательной Доказательное
особенность: Особенность Особенности
бросить: бросить брошу бросил бросите
выброс: выбросы выбросам выбросов
выглядеть: выглядели выглядела выглядит Выглядит выглядеть выглядел выглядят выглядело
встречать: встречаю встречает встречали встречал
актив: активы актив Активы активами активах активом активам активов
допотопный: допотопных
аж: аж
недостаточно: Недостаточно
отрубить: Отрубят
другой: Другими Другая других другими другим другие другую другого другому другой Другие Другое другая другое Другой
покупать: Покупал Покупаешь
сотовый: Сотовая Сотовые
возвращаться: возвращаются возвращайтесь Возвращаясь возвращаться возвращаясь
смотреть: См Смотря Смотрите Смотрим
мшить: МШУ
высокий: Высокая высок высшая высоких высоки высокой высшей высокого высшие высокая высокую высоком высоким высокий высшего
оригинал: Оригиналы Оригинал
консалтинг: Консалтинг
в: в В Во во
адекватный: адекватными адекватную Адекватные адекватного адекватнее
анимация: анимация Анимации анимации
локальный: Локальный
арч: Арч арч
благодарный: благодарен
бабушка: бабушек Бабушкам бабушки бабушку
говориться: говориться говорилось говорится
адресный: адресных адресным адресная адресное
бренд: бренде бренда брендом Бренд бренд брендов бренды бренду
ботавтотест: ботавтотесты
установить: Установите Установил
два: двумя Две двух две два двум Два
браузер: Браузер браузеров браузере браузеры браузерах браузера браузером браузер
богатство: богатства богатство
генеральный: Генеральный
библиотека: библиотекой Библиотека библиотек библиотеку библиотеках библиотека библиотеки
определение: Определение
диагностический: диагностических
вертикальный: вертикальные вертикального
акселерация: акселерацию
основа: Основы
достаточный: достаточную достаточное достаточные достаточным достаточном
безработица: безработицы
обговорить: Обговорите
полагать: Полагаю
детишки: детишки
выходить: выходящий выходили выходя выходят выходить выходит выходил
брат: брату брат братьев
видеоигра: видеоигр видеоиграм
адрес: Адрес адресов адресом Адреса адресами адрес адресу адресе адресам адреса
выделить: выделена выделим выделенным выделил выделенные выделит выделенных Выделенных выделены выделенный выделенного выделить выделенном выделили выделен
говорить: говорит говорят говорим говоря говоришь Говорят Говоря говорю говорить говорили говорил
желать: Желающие желающие желают желающим желающему желающий желающих
выслать: вышлю
доступный: доступному доступные доступным доступной доступна доступными Доступная доступное доступных Доступен доступны Доступные доступный доступен доступного
помогать: Помогаем Помогают
дисплей: дисплей дисплею дисплеев дисплеи дисплея Дисплей дисплее дисплеями
динамически: динамически
блокчейн: Блокчейн блокчейном блокчейны блокчейнов блокчейна блокчейне блокчейнах блокчейнами блокчейн
заместитель: Заместитель
заказ: Заказ
таггар: Таггара Таггар
добавить: добавлено добавив добавил добавлен Добавим добавленного добавьте добавлена Добавить добавим Добавлена Добавлен добавить добавлены добавили добавленные
беспроводный: беспроводные Беспроводный беспроводного Беспроводные Беспроводная беспроводных беспроводной
визит: Визит визиты
экскурсия: Экскурсия
банан: банана банану банане Банана Банан
выяснить: выяснить выяснили
винтажный: Винтажная винтажного винтажных
горизонт: горизонте горизонт
южный: Южной Южная Южном
выпускница: выпускница
переговоры: Переговоры
конкурент: Конкуренты
бесконтактный: бесконтактной
дэнни: Дэнни
девайс: девайса девайсов девайсы девайсе девайсу Девайс девайс девайсах
далтон: Далтон Далтоном
вс: ВС вс Вс
хайк: Хайка Хайк
декоратор: декораторы
гипотеза: гипотез гипотезы гипотеза
брать: брать берет Берешь Брать берут
премия: Премия Премии
диск: дисками диском Диски диски дисках диске дискам диск диска Дисков дисков
выпустить: выпущенной выпущенных выпустить выпустили выпустила выпущена выпущен выпущены
горячий: горячий горячая
витуха: витухи
диалог: диалог диалогах диалоге диалога Диалог
выедать: выедал
дешёвый: дешевое Дешевая Дешевые дешевые дешевый дешевым дешевле дешевая дешевого Дешевой дешевы
скайнуть: Скайнет
начать: Начать Начнут Начнем
мск: МСК Мск
грустный: грустная грустные
врезиться: врезатся
очень: ОЧЕНЬ Очень
мдм: МДМА
поделиться: Поделитесь
пелотон: Пелотон
автоматизированный: автоматизированного автоматизированна Автоматизированный автоматизированное
докер: докер Докер
датчик: Датчики датчик датчиков датчика датчиками датчики
гроза: грозе
обучать: Обучая
рф: РФ
глобальный: глобальную глобальный глобальных глобального глобальная глобальное глобальным Глобальная глобальные
минченко: Минченко
сгореть: Сгореть Сгоревшие
битов: битов
доноситься: доносится
добавлять: добавляют добавляемых добавляла добавлять добавляем добавляет Добавляет
австралийский: австралийская австралийский
хороший: Лучшие Лучший Хорошую Хороший Лучше
цветопередача: Цветопередача
должный: должны должен должным должна должно
выбор: выбором выбор выбора выборе Выбор
уильям: Уильям Уильяма
доработка: доработка
врань: врань
спутать: Спутав
халявный: Халявные
эйлина: Эйлин
входящий: входящих входящем входящего
коллектлить: Коллектли
авария: авария аварию
представлять: Представляет
административный: административное
паламарчук: Паламарчук
детство: детства детстве
ворота: ворота
агент: агенты агентам агентами Агенты агенту агента агентов агентом агент
ввиду: ввиду Ввиду
выход: выходе выхода выход Выхода выходом
она: Ее ее Ей Она ей
связь: Связь
мо: Мо
доменный: доменные доменная Доменные доменное
финансы: Финансы
телек: Телеком
вооружиться: вооружившись
отдельно: Отдельно
вася: Вася Васе
вектор: векторов вектор
красивый: Красивая
бриллиантовый: бриллиантовое
мк: МК
чуять: Чую
главный: главная Главными главный главному главных главной Главный Главная Главные главные главным
жаловаться: жаловался жалуются Жалуется
десятичный: десятичную
вистосема: вистосем
дизайнер: дизайнеров дизайнеры дизайнерам дизайнер дизайнера
доработать: доработать доработанной
агрессивный: агрессивные
безусловно: безусловно Безусловно
дактилоскопия: дактилоскопии
европейский: европейских европейском Европейскому Европейской европейского Европейского европейским европейская европейской
продукт: Продукты Продуктом Продукт
вино: вина Вино вино Вина
использовать: Использовать Используем Использую Используемые
зв: Зв
издавна: Издавна
дружески: дружески
устанавливать: Устанавливает Устанавливаем
абстрагирование: абстрагирование
продакт: Продакт
василий: Василия Василий
доллар: долларом долларах долларов доллар доллара
долг: долга долги долгов долгу
вышка: вышку вышек вышка
ваш: Ваши вашему Ваша Ваш ваш вашими вашим вашей вашего ваша Вашем вашу ваше вашем ваши ваших
дата: даты датами дату дата Дата
бот: Бот бота ботов ботом ботам ботами бот Ботом
земля: Земле Земли
выходной: выходного выходные выходных выходной выходное выходным выходными
порт: Порты Портов Порт
хардж: Хардж
ажиотаж: ажиотажа
вендор: вендорам вендора вендоров вендором вендоры
дотронуться: дотронувшись
ввести: введем введен Введена ввести введены введенную введена введи ввели введенное
уровень: Уровень
воздержаться: Воздержались
мочь: Могу Можете МОЖЕТ Может Могут Можем
посмотреть: Посмотрел Посмотреть Посмотрим Посмотрев Посмотрите
минэкономразвития: Минэкономразвития
вырез: вырезом вырезы
битый: бита битой битая биты битые битый бит
мбитый: МБит
внутрь: внутрь
спикер: Спикер Спикеры
вываливаться: вываливаться
дело: Дело деле делам дело дела дел делами делом делу
маклэйн: Маклэйн
дырявый: дырявые дырявый дырявым
добавление: добавления Добавление добавление
битва: битвах битве
миленько: Миленько
голосовой: Голосовые голосовая голосовым Голосовой голосовые голосового голосовыми голосовых
доктор: доктора Доктор доктор доктору
ковалёв: Ковалевой Ковалева
продолжить: Продолжим Продолжить
третий: Третье Третий Третью
вацапп: Вацаппа
мисис: МИСиС
список: Список
бросать: бросать бросали
верхний: верхней верхних Верхний верхние верхняя
заливать: Заливать
валидный: валидны
жд: ЖД жд
слой: Слой
свернуть: Свернуть
жить: живешь живут жить живет живущая живший живем живу жила жили
вычислительный: вычислительными вычислительны вычислительная вычислительные вычислительной вычислительную вычислительных вычислительным Вычислительными вычислительного
атомарный: атомарно
искусство: Искусство
неинвазивный: Неинвазивная
действенный: действенными действенную действенного
дистрах: дистрах
давление: давлением давлении
ад: ада
достаться: достались достанется
артём: Артем
теоретически: Теоретически
диспропорция: диспропорция
головин: Головин
некрасов: Некрасовым Некрасов
через: Через
правительство: Правительства Правительство
первый: Первые Первый Первую Первая Первое Первой Первыми Первым
вход: входе входа входам входов вход
вакансия: вакансии вакансия вакансий Вакансии
между: Между
обращаться: Обращайся
билет: Билет билетов билет
проблематикауже: ПроблематикаУже
батарея: Батарея батарее Батареи батареи батарею Батарею батарея батарей
акционер: акционеры
рост: Рост
кэролайна: Кэролайн
внешний: Внешний внешний внешняя внешних Внешние внешнему внешнюю Внешних Внешнюю внешними внешнего внешние внешнем внешним внешней
гонять: гоняют гоняет
воткнуть: воткнуть воткнете воткнул
звякнуть: Звякнул
северный: Северной
выдержка: выдержка Выдержка
генерировать: генерировать генерируемого генерируемые генерируют генерирует генерировал
градиентный: градиентным градиентного
насча: Насч
биология: Биология биологию биологии биология
взорваться: Взорвался
взрослый: взрослых взрослым взрослые
кролист: КРОЛИСТ
приём: Прием
анализ: анализу анализом анализ анализа Анализ анализе анализов
дайджест: дайджесте дайджесты дайджест Дайджест
коллекционирование: Коллекционирование Коллекционированием
апдейт: апдейты
от: От ОТ
великобритания: Великобритании Великобритания Великобританией
сравнить: Сравните
сербия: Сербии
медёр: Медер
полуволновой: Полуволновая
скажем: Скажем
африка: Африке Африку Африка
выступать: выступать выступают
плохо: Плохо
туда: Туда
камера: Камера Камеры
интеграция: Интеграция
доверять: доверяем доверяют доверять
ммм: МММ
дима: Дима
альтернативный: альтернативными альтернативной Альтернативно альтернативных альтернативные
множественный: Множественное
десяток: десятков
железка: железки железку железка
ежедневный: ежедневные ежедневной ежедневных ежедневная ежедневный ежедневное ежедневного
тот: Та Те Тот Того
спустя: Спустя
больший: бОльших большим большими большая больший Большая большее больших большие большую большему большей
рогачёв: Рогачевой
болванка: болванки
софт: Софт
вредить: вредят вредит
денежный: денежном денежных денежными денежные
помимо: Помимо
пример: Примере Пример Примерами
даунтайм: даунтайма
децентрализовать: децентрализовано децентрализована
даша: Даша
ждать: ждали жду жди ждут ждал ждет ждем ждать Ждем
возобновить: возобновили
деплой: деплоем
вывести: выведем вывести выведет
нескин: Нескин
беседа: бесед Беседа
забегать: Забегая
видишева: Видишева
внутренний: внутреннем внутренняя Внутреннее внутренним внутренние Внутренняя внутренний внутренних внутреннего внутренней
вечер: вечера вечерам вечер
выступление: выступление
графика: графики графике графика Графика графикой
видеоконтент: видеоконтент
итишник: ИТишников
как: Как
атрибут: атрибут атрибуты атрибута атрибутов
драйвер: драйвера драйверов драйверы драйвере драйвер Драйверы
мелкий: Мелкие
коннектор: Коннектор
борьба: борьба борьбы борьбе
частый: Чаще
роберт: Роберт Роберта
распаковать: Распаковав
тета: Тета
бюджетный: бюджетной бюджетные бюджетным бюджетный бюджетных
взломать: взломать
куль: Куля
выигрыш: выигрыши выигрыше выигрыш
встреча: встреч Встречи встречу встречи встреча
ты: Ты Тебе
степан: Степан
уметь: Умеете Умели
примитивный: Примитивная
бессилие: бессилие
астериск: астериск
второй: Вторая вторую Вторую Вторые вторым второго Второй втором второй вторых вторая
город: городов города городу городом Город город городах Городе городе
ариана: Ариана
сочинение: Сочинения
метод: Методов Метод Методом
достоинство: достоинствах достоинствам Достоинство достоинств достоинство достоинства
спартак: Спартак Спартака
они: Они Им Их
единомышленник: единомышленников
воображать: воображаемых
дом: доме дома дом дому домов
дополнительный: дополнительный дополнительное дополнительная дополнительные дополнительным дополнительной дополнительными дополнительного дополнительную дополнительных
цикл: Цикл
танга: Танг
биос: биосе
банальный: банальное банальные банальна
с: Со С
омск: Омска
указанный: Указанные
инструкция: Инструкция
включать: включающая включать Включаем Включать включал включаем включают включает
геолокация: геолокации
желание: желанию желание желанием желания желании желаний
власть: властью властями власти властям властей
декабрь: декабрь декабря
мб: МБ Мб
мягко: Мягко
совет: Совета Советы
арендовать: арендуют арендовал Арендовать арендовать
вентилятор: вентиляторы
прийти: Пришло Пришла
скрам: Скрам Скраму
вторсырьё: вторсырья
модем: Модем
настройка: Настройка Настройки НАСТРОЙКИ
онлайн: Онлайн
вдвое: вдвое
задачка: Задачки
венчурный: венчурные Венчурные венчурных венчурного
выборы: выборах выборами
нелогичный: Нелогичный
война: войны война войн войну войнам
вступать: вступали вступал вступают
агентство: агентства агентству
вин7: вин7
делить: делить
ведь: ведь Ведь
касперский: Касперского
готовиться: Готовимся готовимся готовиться готовится
болог: бологе
появиться: Появившись Появился Появились Появилась
полиамория: Полиамория
ассайн: ассайн
выкрутасы: выкрутасы
бумажка: бумажка бумажкой
объ: Объ
вайфай: вайфай
стасилович: Стасилович
бизнес: бизнес бизнесов бизнесу Бизнес бизнеса
воздушный: воздушных воздушные
являться: Являются Является
добавка: добавок
провести: Проведите
вуаля: вуаля
анальный: анальных
традиционный: Традиционные
дырка: дырку дырки
годный: годные годный годных
вживую: вживую
пожалуйста: Пожалуйста
активизация: активизации
взорвать: взорваны
смарт: Смарт
выражение: выражением выражениями выражении выражения выражение
впечатление: впечатления впечатлений впечатление впечатлениям впечатлениями
ветеринарный: ветеринарным
корпорация: Корпорация
европеец: европейца европейцу Европейцу
чоу: Чоу
поизучать: Поизучал
внедрять: внедряют внедрять
внимательный: внимательнее внимательного
возможность: возможностью возможностями возможностей возможностях возможностям возможность Возможность возможности
который: Которая Которых Который
плавучий: Плавучий
бридж: бридж бридже бриджу бриджа бриджей бриджи
крюков: Крюков
геймер: геймер геймерам геймерах геймеры геймеров
живой: живых живыми живую живом живым живого живые живой живы Живой жив
выделять: выделять выделяющее Выделяйте выделяют выделяет
владивосток: Владивостоке
бесплатно: Бесплатно бесплатно
выполнять: выполняющего выполнять выполняющим выполняли выполняет выполняющие Выполняем выполняют выполняемых Выполняя
добавочный: добавочному
юдовский: Юдовский
думать: думаете думает Думаю думают думаю думай Думал думал думайте думать
джеф: Джеф Джефа
выше: выше Выше
администратор: администратор администратора администраторы
выявить: выявили выявило выявить
о: Обо О Об
антихакер: Антихакеры
бессмысленно: бессмысленно
дорога: дорогу дороге дорога дорог дороги Дорога дорогой
улпцт: УЛПЦТ
итак: Итак
уже: Уже
впереть: Впер впер
крыша: Крыши
выпадать: выпадающей выпадают выпадающего
делать: делай делать Делают делали делаешь делаете делающие делайте делают делал Делаем делала делая делаю делает делаем
устроить: Устройте
воскресение: воскресенье воскресенья
анонсировать: анонсировали анонсировать анонсировал анонсируемых анонсирует
вкурс: вкурсе
дженерик: Дженерики
тривиальный: Тривиальные
неокортекс: Неокортекс
покупатель: Покупатели Покупателями
выдавать: выдавать выдаваемые выдавали выдавал
арендный: арендные
секретный: Секретная
ведомство: Ведомство ведомства
глубина: глубине глубину глубина глубины глубинах
востребовать: востребованных востребованный востребован
вышесказанный: вышесказанного
падать: Падает
белый: белого белых белый белом
глючность: глючность
существующий: Существующие
геморой: гемороя
датацентр: датацентр датацентрами датацентра
авиакомпания: авиакомпаний
вот: вот Вот
голландец: голландец
обмен: Обмен
слава: Слава
россия: Россия России Россию
железо: железо железа железу железом
казань: Казани Казань
ассоциация: ассоциации ассоциацию
на: НА На
балаган: балагане
подобный: Подобный Подобные Подобная
запись: Запись Записи
документ: Документы документов документ документы документе документах
пользоваться: Пользуюсь Пользуясь
достигнуть: достигли достигло достичь достигнуть достигнем достигнет достигла
автоматизировать: автоматизируем автоматизировать автоматизировал автоматизируйте автоматизируют автоматизированы
брызгать: брызжет
безвозвратно: безвозвратно
кабель: Кабель
веяние: веяниям веяниями
лифшиц: Лифшица Лифшиц
вуа: вуа
вовлечь: вовлеченными
выводить: выводя выводим выводят выводит
лепченков: Лепченков
тонкость: Тонкости
перестать: Перестаньте
раз: Раз
деревенский: деревенский
гигабит: гигабит
ключ: Ключи
выбирать: выбирая выбираете Выбирайте выбирает выбираю выбирали Выбираем выбирал выбираем выбираешь выбирают выбирать
мацкевич: Мацкевич
версия: версиями версиях версий версии версия версией версию
галочка: галочке галочек галочкой галочка галочки галочку
велосипед: велосипеда
взлететь: взлетела взлетит
объективно: Объективно
взяться: взялся возьмусь взяться
владелец: владельцам владельца владельцами владелец Владелец владельцем владельцу владельцы владельцев
балкон: балконе балкона балкон
доверие: Доверие доверия доверию доверием
врач: врачам врачи врачей врача Врач врачу
создать: Созданные Создав Создадим Создать
независимо: Независимо
аллан: Аллана Аллан Алланом
поддержка: Поддержки Поддержка
загружать: Загружать Загружаем
беспомощность: беспомощность
тьерри: Тьерри
жадно: жадно
диагностика: Диагностика диагностики диагностике
выгореть: Выгореть выгорел выгорели выгоревшими выгореть выгоревших
анализироваться: анализируется
жизнеспособный: жизнеспособна
выкладывать: выкладывать выкладывают выкладывает выкладываешь
гид: гид
положительный: Положительным
сложно: Сложно
макао: Макао
выдать: выдаст выданы выдать выданной
энгельбарт: Энгельбарт
бит: битах
жест: жесты жест жестов жестами
аргумент: аргументами аргументы аргумент аргументе аргумента
получаться: Получалось Получается
ближний: Ближнем Ближнего
джаред: Джаред
быстрый: быстрые быстрого Быстрая быстрой быстрых быстрое быстрее быстрый быстрым быстрыми Быстрое быстрая быструю
адаптировать: адаптированных адаптировать
борт: борту
бак: баки
автономность: автономности автономность
климонтович: Климонтович
длинный: длиннее длинного длинный длинными длинных длинным длинной Длинные длинном
ванильный: ванильного ванильное
информационный: Информационная
вернуть: Вернуть вернуть
важный: Важна важны важнейших важную важные важной Важная Важный важный Важное важен важному важных важная важным важна важнейшим важнее важное Важные
андроид: андроидов андроидом андроида андроиду Андроиде андроид Андроиды Андроид
ясно: Ясно
гражданин: граждане гражданам гражданами граждан
манхеттен: Манхеттен
переводить: Переводя
смысл: Смысла Смысл
начинать: Начинайте Начиная
выгодный: выгодное выгоднее выгодный выгоден выгодные
гугловатый: гугловатый
постановление: Постановлением Постановление
хьюстон: Хьюстон
владение: владении владения владение
король: Король
просьба: Просьба
вылететь: вылетела
документальный: Документальный
дополнять: дополнять дополняют дополняющее
максим: Максима Максим
самый: Самым Самая Самое Самые Самый
блочный: блочного блочный блочному блочное
откровенный: Откровенная
гроссбух: гроссбух гроссбухом гроссбухе
возникнуть: возникшие возник возникнуть возникли возникнут возникла возникший возникло
ютуба: Ютубе Ютуб
есть: едят Есть ест есть ем
сетевой: Сетевые Сетевое Сетевой
базироваться: базируется базирующейся базируются
го: го
гормон: гормон гормонов
быстрорастущий: быстрорастущих быстрорастущей быстрорастущим
мой: Мой Моего Мои Моя
приступать: Приступая Приступаем
многопользовательский: Многопользовательские
таблица: Таблица
поддельный: Поддельные
выполнить: выполнено выполнить выполнен выполнив выполнила
временизапрос: времениЗапросы
вероятный: вероятен
евросоюз: евросоюза Евросоюза Евросоюзе Евросоюз
штраф: Штраф
изоляция: Изоляция
совпадать: Совпадать
алгоритм: алгоритме алгоритмы алгоритмами алгоритмов алгоритм алгоритму
андрей: Андрею Андрей
жизнь: жизни жизнью жизнь
виртуальный: Виртуальное виртуальному виртуального виртуальное виртуальным виртуальная Виртуальная виртуальном Виртуальный виртуальные виртуальный виртуальную виртуальных виртуальной виртуальными Виртуальные
хоровица: Хоровиц
весить: весил весит весить
грохнуть: грохнули
включение: включения включении
беда: беды беда
четырёхдневный: Четырехдневная
главное: Главное главное
вы: Вам Вас вас Вы вам вы вами
глючить: глючил глючит
традиционой: Традиционые
пик: Пик
калифорния: Калифорния Калифорнии
гаджет: Гаджеты гаджеты гаджетам гаджетов
янг: Янги Янг
блестеть: блестит
подробный: Подробные Подробного Подробнее Подробный
данные: данными Данных данным данных
дедушка: дедушки дедушка
барахло: Барахло барахла барахло
получить: Получим Полученный Получив
дискета: дискет
банкинг: банкингом банкинг банкинга
коннора: Коннора
душевный: душевных
мужчина: Мужчина
вновь: вновь
жертвовать: жертвовать жертвуете
журнал: журналах журналов журнале журнала журналы
открытие: Открытие
такой: Такое Такого Такую Таким Такой Такая Таких Такие
франция: Францию Франции
большой: большом большому большое большой Большой велик Больше больше большого Большого
электрический: Электрические
озуа: ОЗУа
дрова: дров
рнко: РНКО
владеть: владеть владеющими владеет владеете владеющего
принцип: Принципы Принцип
основать: Основан Основанная
параметр: Параметры Параметр
абсолютный: абсолютное абсолютных абсолютную абсолютная абсолютным
аналогично: Аналогично аналогично
новиков: Новикова Новиков
преподноситься: Преподносится
сюда: Сюда
александр: Александр Александра
быт: быта
всякий: всякие Всякий всякой всякое всякий всяком всякими Всякое всяких
эльбрус: Эльбрус
дырявный: дырявен
уничтожить: Уничтожить
дроп: дропам
доцент: доцент
доля: долей Доля доли долями доля долю
вендорский: вендорского вендорский вендорских
виртуализация: виртуализации виртуализацию виртуализация Виртуализация
ересь: ересь
определять: Определяющей Определяющие Определять
ярошевский: Ярошевский
внимание: внимания вниманию внимание вниманием ВНИМАНИЕ
долговременный: долговременный долговременной долговременное
строго: Строго
объектный: Объектная
ведомственный: ведомственные
выгорать: выгорала выгорают выгорающей выгораем
намного: Намного
высокоуровневый: Высокоуровнево Высокоуровневая
вычислить: вычислили вычисленным
временной: временным временной временные временная временными Временная временных
высокочастотный: Высокочастотная высокочастотным высокочастотном высокочастотной
взламывать: взламывая взламывать
дисковый: дискового
евгений: Евгения Евгений
эмиль: Эмиль
сингапур: Сингапур
реклама: Реклама
ца: ЦА
научный: Научные
беллара: Беллар
воспроизведение: воспроизведением воспроизведения Воспроизведение
несекурно: Несекурно
вымереть: вымерли
единичный: единичный единичную единичных
отойти: Отойти
выносить: выносить выносили выносят
говно: говна говно говнами
отчий: Отчего
готовить: готовит готовить готовят готовим Готовим
швейцария: Швейцарией Швейцария
альтернатива: альтернатива альтернативами альтернатив альтернативы альтернативу
протестировать: Протестировать
идти: Шел Идем
выручка: выручка выручки Выручка выручку
дистрибутив: дистрибутивов дистрибутиве Дистрибутив дистрибутива Дистрибутивы дистрибутивах дистрибутив дистрибутивами дистрибутивом дистрибутиву дистрибутивы
выступ: выступами
желательно: желательно
ёмкость: емкостью емкости
дальний: дальний дальнего
волонтёрский: волонтерские
вызывать: вызывают вызывает
дёргать: дергать
администрирование: администрирование администрирования Администрирование
выбраться: выбраться
большинство: Большинство большинству большинстве большинство большинства большинством
разнообразие: Разнообразие
протокол: Протокол
передача: Передача
возрастание: возрастанию
буква: букв буквы букву
увлекательный: Увлекательная
кэролин: Кэролин
западный: Западном Западной
вычисление: вычислений вычисления Вычисление вычисление
деталь: деталей Деталь деталь Детали детали
алгоритмический: алгоритмические алгоритмическое алгоритмическому
будущий: будущей будущих
личный: Личные Личный
святенко: Святенко
обязательно: Обязательно
пройти: Прошла
посевная: Посевные
жизненный: жизненный жизненного жизненной жизненным
ким: Ким
гибридный: Гибридный гибридный гибридное
десятый: десятых
благо: благами Благо блага
али: Али али
бета: бету бете бета Бета
павел: Павел
катя: Катя
статья: Статья Статьи
последний: Последняя Последние Последний
офисный: Офисные
монополизация: Монополизация
дядя: дядя
алексей: Алексей Алексея Алексеем
водоворот: водоворот
оригинальный: Оригинальный Оригинальное
мортить: Морти
сельскохозяйственный: Сельскохозяйственный
настолько: Настолько
верить: верит верим верить верю
беременность: беременность
железный: железных железные железная железного железный
вопрос: вопросов вопросы вопросам вопроса вопросом вопрос вопросу Вопрос вопросах Вопросы вопросами вопросе
число: Число
стаценко: Стаценко
объединение: Объединение
стэнли: Стэнли
изменять: Изменять
вправо: вправо
адресувтора: адресуВторой
проверять: Проверяем
непримиримый: Непримиримые
выдача: выдачи выдачу
вкладка: вкладки вкладке вкладок
естественный: естественным естественные естественного
некоторый: Некоторое Некоторые
автомат: автоматами автомат автоматом автоматы
макбук: Макбука МакБук
боец: бойца
латинский: Латинской
немудрено: Немудрено
отсутствие: Отсутствие
брайант: Брайант
цифровой: Цифровое Цифровая Цифровые Цифровом
он: Его Он ему его
база: база базы базе базам баз базой базу
перевод: Переводы Перевод
водопадный: водопадный
ведущий: ведущий ведущая ведущим ведущих ведущего
бывать: бывает Бывают Бывали бывают
зайд: Зайд
включительно: включительно
воспользоваться: воспользовались воспользуемся воспользоваться
артемюк: Артемюк
современный: Современный Современная Современным Современные
боль: боль боли болями
унификация: Унификация
дань: дань
воркспейс: воркспейса
глушить: глушить глушили глушит
работать: Работаю Работает Работал Работать Работаем Работают
лайфхак: Лайфхаки
управление: Управлением Управление
тиль: Тиль
выясниться: выяснится выяснилось
аарон: Аарон
вставляться: вставляется
греться: греться греется
москва: Москве Москва Москвы
деплоить: деплою деплоя
мбайт: Мбайт
не: НЕ Неом Не
единоразавать: Единоразавая
доступность: доступности доступностью доступность
вознаграждение: вознаграждение
беспроблемный: беспроблемную беспроблемно
донгл: донгле донгл донглы
длительный: длительный длительное длительную
когда: Когда
белесый: белесой
дзен: Дзен
диван: диване диван
глубинный: глубинного глубинную
социальный: Социальные Социальная Социальное
возвращение: возвращение возвращением
отключать: Отключаем
агитировать: агитирую
украина: Украины
жалоба: жалоб
герой: Герой героями герой героев героя
коротина: Коротин
крамар: Крамар
единица: единиц единицей единица единице единицам единицы
зел: Зел
заниматься: Занимаются Занимается
ибо: Ибо
жрать: жрущий жрал
новый: Новую Новом Новая Новые Нового Новой Новый
материнский: Материнскую Материнские
гражданский: гражданских гражданскую
язык: Язык
взаимоувязать: взаимоувязаны
основный: Основное Основная
виндовс: Виндовс
выпускать: выпускают выпускать выпускаемый выпускаемой выпускает
наличие: Наличие
спецификация: Спецификация
бируль: Бирули Бируля
автомобиль: автомобиль автомобилями автомобилей автомобиля автомобили
потребоваться: Потребуется
экономия: Экономия
организатор: Организаторы
остальной: Остальное
десять: десять
включить: включим включена включили включено включен включил включить включенным включены
волкер: Волкер
давать: давало Давайте дававшие даем давал давать дающей дают дает давайте
вариться: варится
березников: Березников
патреха: Патрех
бриджить: бриджить
источник: Источники Источник
понятно: Понятно
ахти: ахти
расписка: Расписку Расписка
группа: группам Группы группе группа групп группой группами Группа группы группу
выкатить: выкатил
долго: Долго долго
депрессия: депрессии депрессия депрессию Депрессия депрессией
аспект: аспект аспектах аспекты аспектов аспектам
запчасть: Запчасти
виджет: виджете виджетов виджету
вздох: вздох
автомобильный: автомобильных
выполнимый: выполнимыми выполним Выполним
харрис: Харрис
героиня: героини
ряд: Ряд
вода: воде водах вода Вода воды воду водой
безобразие: безобразия
великий: великим великом великого Великие Великий величайших Великих великий
активация: активаций активации
доставка: доставку доставкой доставок доставке доставки доставка
цод: ЦОД
гардероб: гардероб
дополнительно: Дополнительно дополнительно
восприятие: восприятия
вымотать: вымотаны
имя: Имя Имена
дорожать: дорожая Дорожать дорожать
удаться: Удалось
ладный: Ладно
воплощение: воплощение воплощением воплощении
начинающий: Начинающие
поздний: Позже Поздний
общий: Общая
беспокоить: беспокоят беспокоит
американский: американских американская американской американские американского
деградация: деградации
слушаемть: СлушаемВ
душа: душу Душ душа душ душой душе душам души
вместо: вместо Вместо
тег: Теги Тег
даташитый: даташиты Даташиты даташита даташит
банковский: Банковские банковском банковское банковские банковских банковского
видосик: видосики
браузерный: браузерными браузерное браузерных
диапазон: диапазонов диапазонами диапазон диапазоном диапазоне диапазона диапазоны
арабский: арабских
митапа: Митап
неплохо: Неплохо
барахолка: барахолке барахолки барахолка
брайан: Брайан
выживать: выживать
ненавидеть: НЕНАВИЖУ
скандинавия: Скандинавия
брак: брака браком брак
профилактический: Профилактическая
децентрализованный: децентрализованных децентрализованной децентрализованная децентрализованные
банкомат: банкоматов
детальный: детальный
столкнуться: Столкнулся
кризис: Кризис
линукс: Линуксе Линукс Линуксом
выбрасываться: выбрасывается выбрасываться
дуб: Дубов
асимметричный: асимметричную Асимметричная асимметрична
искусственный: Искусственный
груша: груше
дюйм: дюйма дюйм
жалко: жалко
аккума: аккум
вариант: вариантов Вариантов вариантом варианту вариантах вариант варианте варианта варианты вариантами Вариант
культура: Культура
если: Если если
массачусетс: Массачусетс
имитационный: Имитационная
витамин: витамины
двигаться: двигаешься двигаются двигаться двигается движутся
взять: взял возьмет возьмем взята Взял возьмут взяла Возьмем взять взяты взяли
врываться: врывается
варьироваться: варьироваться варьируются варьируется
актуальный: актуальными актуальные актуальной актуальное актуальным актуальна
рассматривать: Рассматриваемая
переменный: Переменная
закончиться: Закончиться
клочко: Клочко
пермь: Перми
вестись: велась ведется
вебсайт: вебсайту
высокопроизводительный: высокопроизводительного
по: ПО По
беззвучный: беззвучный
эксперимент: Эксперимент Эксперименты
генерация: генерацией генерация генерацию генерации
вщ: вщ
сразу: Сразу
вуз: вузами вузе вуз ВУЗе
патрик: Патрика Патрику Патрик
стоимость: Стоимость
анализировать: анализируем анализировать анализирующий
юрий: Юрий Юрия
аутентификация: аутентификацию аутентификация аутентификации
архитектурный: архитектурные архитектурных
днёвка: дневка дневку дневки
выскодоступный: выскодоступное
достать: достать достали
ронко: Ронко
аккуратно: Аккуратно
дерево: дерева деревьев
амбициозный: амбициозные амбициозными
батарейка: батарейку Батарейка батарейки батарейкой батарейка
безопасно: безопасно
стандартный: Стандартной
встретиться: встретятся встретится встретишься встретиться встреться
екатерина: Екатерина
бенчмарка: бенчмарки бенчмарке
чат: Чат
ещё: еще Еще ЕЩЁ
библиотечный: библиотечных библиотечное библиотечным библиотечный
складской: Складская
опытный: Опытный
док: Док док
гетеродин: гетеродин
рабочий: Рабочие
райзер: Райзеры
вальяжно: вальяжно
восстанавливать: восстанавливаемого восстанавливает восстанавливаете восстанавливать
вильямс: Вильямс
ошибка: Ошибка Ошибки
байт: байт байта
олег: Олег
батарейный: батарейном
антенна: антенны антенну Антенну антенн антенна Антенна
логично: Логично
дежурный: дежурного
выбираться: выбирается выбирался
дикарство: дикарстве
практический: Практические
гиперконвергентный: гиперконвергентные
встречаться: встречавшихся встречался встречается встречаются встречаться
карьера: Карьера Карьеры Карьере
воображение: воображения воображением
баш: баше
восстановление: восстановления восстановление
воевать: воевать
динамический: динамическую динамическая динамической Динамическая динамические
прогулка: Прогулка
сам: Сами Самих Сама Сам
ботан: ботанов
за: За
конспект: Конспект
печально: Печально
потребление: Потребление
встроить: встроенным встроены встроенное встроенных встроенную встроенная встроить встроен встроенного встроенной встроенный встроенные
чипсы: Чипсы
интернет: Интернета Интернетах Интернет
аппарат: аппарат аппаратов аппарата аппарате
становление: Становление
мы: Нам Нами Мы
понятие: Понятие
эх: Эх
минприрода: Минприроды
ека: ЕКА
выложить: выложил выложить выложила выложу
близкий: ближайшие ближайших ближайшем близких близка ближайшую ближе ближайшее близкими ближайшего близкий близкие
антеннаэтота: антеннаЭтот
беготня: беготня
либо: Либо
трудность: Трудности
отличаться: Отличается
беспрепятственно: беспрепятственно
ватт: ватт Ватт
вытеснить: вытеснив
метеорологический: Метеорологической
грубо: грубо
верный: верное вернее верный
технологический: Технологическая
взыскание: взыскание
поддерживаться: Поддерживаются Поддерживается
атс: АТС
пара: Пара Пару
запатентовать: Запатентованное
домашний: домашнем домашней домашний домашних домашние домашнего домашнюю
биллинга: биллинг
договориться: договориться
босменить: Босмени
более: Более более
видеофайл: видеофайлов
запустить: Запустить Запустим
адаптация: адаптации адаптация
беларусь: Беларуси Беларусь
выбрать: выбранный выбрал выбранных выбранными выберу Выбрать выбрав выбрать выбрали выберет выбран выбраны Выберете выбрана
выписка: выписку
взаимодействие: взаимодействие взаимодействия Взаимодействие
исландия: Исландии Исландия
важно: важно Важно
предварительный: Предварительная
двести: двести
песочница: Песочница
городить: городить
впустить: впустите
артаньян: Артаньян
вниманиякодирование: вниманияКодирование
единый: единого единым едином единой единый единое единую
видимый: видимого видимой видимый
глубоководный: глубоководных глубоководный
хайнлайна: Хайнлайна
пол: Полом Пол Полу Пола
дюжина: дюжины
миллион: Миллион Миллионы
плата: Плата Плат
джобс: Джобса
частота: Частоты Частота
какой: Какое Какой Какая Какую Какие
аудитория: аудиторию аудитория аудитории аудиторией
саудовский: Саудовской
двухзначный: двухзначное
специалист: СПЕЦИАЛИСТЫ Специалисты Специалист
транскрипта: Транскрипт
нарекание: Нареканий
взрыв: взрыву взрыва
опек: ОПЕК
ватикан: Ватикан
выживание: выживание выживанию выживания
ассемблер: Ассемблере ассемблере
выгода: выгоду выгодой выгоде выгоды
тим: Тим
везде: везде Везде
патентный: Патентное
введение: введения Введение введением
грэмстартапвенчурный: Грэмстартапвенчурные
диверсия: диверсий диверсии диверсию
позволить: Позвольте
победа: Победа
подборка: Подборка
аукцион: Аукционы аукционов аукционе
токарь: Токарь
детский: Детская детские детским детского
предупредить: Предупрежден
гигантский: гигантское гигантские гигантским гигантский
белорус: белорусов
женский: женским
значок: Значки
влан: влан вланов влана влане вланы
адепт: Адепты адептом
без: Без без
хоусон: Хоусон
аналогичный: аналогичный аналогична аналогичная Аналогичный Аналогичная аналогичными аналогичные
дневный: дневной дневная дневную дневных
всплыть: всплывший
вторичный: вторичных вторичный
ктулху: Ктулху
минималистичный: Минималистичный
яндекс: Яндекс
благотворительность: благотворительность
революция: Революция
внимательность: внимательность
объединить: Объединить Объединенная
внушать: внушает
домохозяйка: домохозяйка
предлагать: Предлагаю Предлагать Предлагали
готовый: готовы Готовы готова готовым готов готовая готовую готовых готовый готовой готовые Готовые готово
опрос: Опрос
сбербанк: Сбербанк
долгий: долгие дольше долгий долгих
медицинский: Медицинские
возможный: возможное возможные возможны возможен возможной возможных возможную
волошин: Волошин
питтсбург: Питтсбург
арматура: арматурой
якямсесть: Якямсев
вправе: вправе
джаггернаут: джаггернаута
вместе: вместе Вместе
бендер: Бендер
спасибо: Спасибо
государство: государством государств государства
домохозяйство: домохозяйство
криптобабло: Криптобабло
аккумулятор: аккумулятором аккумуляторы аккумулятора аккумуляторов аккумулятор
каталог: Каталог
фиксировать: Фиксируем
вернуться: Вернулась Вернись вернуться вернулся вернулось Вернуться вернемся Вернемся вернулась
джекпот: джекпот
выступить: выступили
володарский: Володарский
экономика: Экономика
голландский: голландским голландский
убрать: Уберу
вложение: вложение вложения вложений
бесконечный: бесконечную бесконечны бесконечная бесконечного
ансамбль: ансамблей ансамбли
поточный: Поточный
алкоголик: алкоголик алкоголики
бытовой: бытовых бытового бытовую бытовой бытовые
заремба: Заремба
сдвиг: Сдвиг
мигрировать: Мигрировать
завод: Завод
выпрашивать: выпрашивали
крупный: Крупнейшие Крупнейших Крупные
сбер: Сбер Сбера Сбере
недавно: Недавно
аффективный: аффективное
обеспечение: Обеспечение
дикий: дикий дичайшие диким
марат: Марат
вырубить: вырубить вырубил
былой: былой
альберт: Альберт
алиэкспресс: Алиэкспресса алиэкспрессе
адора: Адора Адоры
копеечный: Копеечными
вмс: ВМС
вероятно: Вероятно вероятно
британский: британской британская Британская британских британские
деструктивный: деструктивный
экс: Экс
быстренько: Быстренько
высказать: высказал высказанных
доширак: дошираке Доширак
джунгли: джунглей
объяснение: Объяснение
влиять: влияет влиял влияли влияют влиять
понимание: Понимание
объектив: Объективы Объектив
громоздкий: громоздкий
отсюда: Отсюда
определиться: Определиться
пояснение: Пояснения
водяной: водяные
космический: Космический
водопад: водопадом водопада
оптимизировать: Оптимизированы Оптимизировано Оптимизирован
впрочем: впрочем Впрочем
сапольски: Сапольски
трансформация: Трансформация
белград: Белград
волонтёр: волонтеров
влево: влево
емнип: ЕМНИП
мда: Мда
бум: бум
исполнительность: Исполнительность
выгул: выгулом
белорусский: белорусского Белорусский белорусские белорусский
аккаунт: аккаунты Аккаунт аккаунт аккаунтов аккаунте аккаунтом
хьюбераразный: ХьюбераРазные
мозг: Мозг
гудеть: гудит гудел
продать: Продать
островок: Островок Островка
русский: Русский
бессонница: бессоннице бессонницы
едва: едва
англичанин: англичанами
впритык: впритык
версииа: версииА
губка: губкам губки
выключить: выключен выключены выключим выключить выключил
тан: Тан
деш: Деш деш
сказать: Скажите Сказать Скажу
бюро: бюро
позавчера: Позавчера
умберто: Умберто
бизнесмен: бизнесменов Бизнесмен
справедливость: Справедливости
дофига: дофига
достижение: достижении достижениям достижения
сильно: Сильно
администрированиесистёмный: администрированиеСистемный
вобщий: вобще
больной: больная больных
так: Т Так
странно: Странно
выключать: выключать Выключаем
зачастую: Зачастую
попасть: Попасть
вышестоящий: вышестоящем вышестоящим вышестоящими
грамотный: грамотном грамотных
маленький: Мал Маленьких
команда: Команды Команда
до: До до
вспомнить: вспомнит Вспомни Вспомните вспомнил Вспомнить вспомнить вспомним вспомню
родный: Родной
неделя: Неделю
гончаров: Гончарову
фсб: ФСБ
итог: Итоги
стандарт: Стандарты Стандарт
единичка: единичек
себя: СЕБЯ
бинарный: бинарная бинарному
бояться: бойся бояться боится бойтесь боитесь
облако: Облако Облака
битный: битное битная битную битным битный битных битные
центробанк: Центробанка
бумага: бумаги бумагу бумаге
правда: Правда Правде
ввод: ввода
пересказ: Пересказ
подписаться: Подпишитесь Подписаться
наш: Наша Нашей Наши Наше Наш
убер: Убера
программа: Программы Программа
вом: вом
выйти: вышедшая выйдет выйти Выйти вышел вышло вышла вышедших вышедшие
бодрый: бодрее
грозозащита: грозозащита грозозащите
хакер: Хакеры Хакера Хакер
патречь: Патрег
резонный: Резонный
береговой: береговой
кокорича: Кокорича
неблагодарный: Неблагодарный
что: Шо Что Чего Чему
вырабатывать: вырабатывать
белла: Белла
бартрам: Бартрама Бартрам
праут: Праут
дать: дал дали данной данному дан даст данные Дайте Данные дайте дала Данная дай дать дам данная
человеческий: Человеческая
алготорговля: алготорговлей
будущее: Будущее будущем будущего будущее будущим
тирания: Тирания
объяснить: Объясните
взлетать: взлетает
дефолтный: дефолтным дефолтный дефолтных дефолтного дефолтными
нейронный: Нейронные
вычислять: вычисляла вычисляют вычислять
особенно: Особенно
лидерство: Лидерство
деятельность: деятельности деятельность деятельностью
гостайный: гостайна
екатеринбург: Екатеринбурге Екатеринбурга
хитрый: Хитрая
модульность: Модульность
телеграм: Телеграм
ранний: Раньше
духовка: духовке
гаджетомать: гаджетоманы
марк: Марк
достойный: достойной
жена: жену
тасс: ТАСС
женщина: Женщины женщин
желаний: желаниеВ
дорогой: дорогие дорогая Дорогая дорогую дорогое дорогим дороже дорогих
директор: директор директором директора Директор директоров
английский: английского английский Английский английском английские английскому
бедный: бедных
турция: Турция Турции
боинг: боинга
нигерия: Нигерия
правило: Правило Правила
бассейн: Бассейны
выпуск: выпусков выпуск выпуска выпуском
индия: Индию
вилкинсон: Вилкинсон
асинхронный: асинхронных Асинхронное асинхронного
соловьёв: Соловьев
гигабайт: гигабайт гигабайта гигабайтом
градус: градус градусов
отличие: Отличия Отличий
сомневаться: Сомневаюсь
файловый: Файловое
железа: железе
дойти: дошли дошло дойдет
девушка: девушки девушку девушек
отдавать: Отдаю
каждый: Каждую Каждый Каждое Каждая
популярность: Популярность
показывать: Показывать
валюта: валюту валюта
жанга: Жанг
категорийный: Категорийный
применить: Применить
командный: Командная
адаптивный: адаптивным
пропагандироваться: Пропагандируется
дублирование: дублирования дублирование
запуск: Запуск
квантовый: Квантовые
выпускаться: выпускается
скб: СКБ
сделать: Сделали Сделай Сделаем Сделать Сделав Сделан
держать: держать держали держит
дефицит: Дефицита дефицит Дефицит дефицита дефицитом
видеошлем: видеошлемов
некорорый: Некорорые
дисклеймера: ДИСКЛЕЙМЕР Дисклеймер дисклеймер
обычный: Обычные
тоннель: Тоннель
поэтому: Поэтому
диджитализация: диджитализацией
основание: Основание
хотеть: Хошь Хотите Хочет Хотел
технически: Технически
дополнить: дополнили дополнить дополненная
ах: ах
дублировать: дублировать
новогодний: Новогодние
финляндия: Финляндия
динамика: динамикой Динамика динамику динамики
ваня: Ваня
античный: античные
разный: Разные Разная
гк: ГК
чсв: ЧСВ
думаться: думается
сайт: Сайт Сайты
окончательный: Окончательное
внедрение: внедрении внедрение внедрения внедрением
гигагерц: гигагерца
водитель: водителей водитель водителю
под: Под
визуализировать: визуализировать
ч: Ч
грешный: грешную
надёжность: Надежность
партнёр: Партнеры
фридман: Фридман
возвращать: возвращают возвращая возвращал возвращает возвращать
но: Но НО
поттер: Поттера
ами: ами
видеоролик: Видеоролик видеоролики видеороликов видеоролика видеороликах
звучать: Звучит
вводить: вводить вводим вводишь вводит
аннотация: аннотацию аннотации
выработка: выработке выработку
информация: Информации
кремниевый: Кремниевую Кремниевая Кремниевой
фармацевтика: Фармацевтика
график: графиком график
профиль: Профиль
ожидаться: Ожидалось
расслабление: Расслабление
кпд: КПД
около: ОК Около Ок
гибкость: Гибкость гибкость
боковой: боковыми
грубый: грубую груба грубых
весьма: весьма
антимонопольный: антимонопольные
поработить: Поработившая
ниже: Ниже
видеокарта: Видеокарты видеокарта видеокартами видеокарт Видеокарта видеокарты
комфортный: Комфортный
виталий: Виталий
посмотрить: Посмотрима
физический: Физическая
нужно: Нужно
никакой: Никаких Никакого Никакой Никакие Никакая
договор: договоры договоров договора договору
дополнение: дополнение дополнению дополнения
гугл: гугла гугл Гугл гуглу
арма: арм Арм
бедовый: бедовые
восстановить: восстановить восстановлены восстановлена
вспышка: вспышкой вспышек вспышки вспышками вспышку
волокно: волокна
долина: Долины Долина Долине долиной долины долине долина долину
быстродействующий: быстродействующих быстродействующей
александра: Александры
географический: географических
файфер: Файфер
балконный: балконной
добраться: добраться добрался
была: былы
симпатический: Симпатическая
давний: давнюю давние давней
эффективный: Эффективный Эффективная Эффективных
воскресить: воскресила
вырвать: вырвать
крутой: Круче Крутые
авангард: авангардом
си: Си
гарантированно: гарантированно
пермяк: Пермяки
внедрить: внедрили внедрить внедрена
разумовский: Разумовский
сэм: Сэм
делаться: Делается делаться делается делался
бетон: бетон
россельхозбанк: Россельхозбанка
европа: Европы Европа европе Европе Европой
доша: Доши
догнать: догонит
гнездо: гнездом
кпо: КПО
топ: ТОП
автоматизация: автоматизацию автоматизации автоматизацией автоматизация
глаз: глазами глазах глаз глазам глаза
оценить: Оценить
хадид: Хадид
шрифт: Шрифты
явление: Явление
вниманиярассмотреть: вниманияРассмотрим
моторола: Моторолы Моторола
использоваться: Использоваться Используется
декодировать: Декодировать декодировали декодировать декодируемые декодируем декодирует
америка: Америка Америку Америки Америке
безусловный: безусловного
приватный: Приватная Приватное
вручить: вручили
возюкатя: возюкать
выпускник: выпускники выпускник выпускников
агрегация: агрегация агрегацию агрегации
квалкома: Квалкома
лина: Лин
продажа: Продажи Продажа
снизу: Снизу
майкл: Майкл
финальный: Финальный
древний: древний древние
интервью: Интервью
айтишный: айтишная
окей: Окей
высоконагруженный: высоконагруженные высоконагруженных высоконагруженными высоконагруженной
синтаксис: Синтаксис
вовсе: вовсе
восхитительный: восхитительный
железокомплектовать: железокомплектующие
ип: ИП
позвонить: Позвонили
аплодисментовзря: аплодисментовЗря
профессор: Профессор
дн: дн
дыхание: дыхание дыхания
выравнивание: выравнивания
адресовать: адресовать Адресовать
старый: Старый Старые
школа: Школа
бодрость: бодростью
финансовый: Финансовые Финансовая
ходченков: Ходченкова
босния: Босния
настроить: Настроить
виртуализировать: виртуализируем виртуализированную виртуализировали виртуализированным виртуализированных
ввп: ВВП
хромбук: Хромбуки
вдохновить: вдохновлен вдохновили
выстраивать: выстраивают выстраивать
блютуз: блютуз
вменяемый: вменяемое
гадость: гадость
приходить: Приходит
ветка: ветку ветки ветке ветка
тепер: Тепер
просить: Прошу
начало: Начало
вложить: вложить вложил
включаться: включается включалось включаются
трэйся: Трэйси
глава: главы Глава глава главу
оценка: Оценка
выговариваться: выговариваются
международный: Международного Международный
связка: Связка
запорожец: Запорожца Запорожец
винд: винду винда винде Винда
дарение: дарения
кричать: Кричать
многозадачность: Многозадачность
датасет: Датасет датасета
стародубцев: Стародубцев
алкоголь: алкоголь алкоголя алкоголем Алкоголь
секс: Секс
скидка: Скидка
кро: Кро
гранатовый: гранатовый
егоров: Егоров
ежеминутно: ежеминутно
азбука: азбуку азбуке азбуки
девять: Девять
авторизовать: авторизованной
акт: акту акты
граф: графов графе граф графа
борец: борцы
трудоголизм: Трудоголизм
бордерный: бордерных бордерными бордерным
генетический: генетических генетическое генетического
множество: Множество
повышаться: Повышается
йозеф: Йозеф
доход: доходы дохода доходу доход доходов
апплет: апплетах
разве: Разве
рон: Рон
оранж: Оранж
процессор: Процессор
бин: бин
дубровка: Дубровка
алкогольматематикасавватеев: алкогольматематикасавватеев
выплачивать: выплачивают
вика: вики
сколково: Сколково
электроника: Электроника
есдить: Есди
двое: двое
регистрация: Регистрация
ос: ОС
часть: Часть
восприниматься: воспринимается воспринималось
дежурить: дежурить
повторимый: Повторим
а: а А
флагман: Флагманом
аппартный: аппартная
долгосрочный: долгосрочной долгосрочное
создаваться: Создается
гиг: гига гигом гигами гиг гигов
это: Этим Это ЭТО
грешок: грешки
прошивка: Прошивки
фича: Фичи
банкротство: банкротство банкротства
вниманиямногий: вниманияМногие
беспилотный: беспилотные беспилотную
проклятие: Проклятие
видеоархив: видеоархивы видеоархив
тиньковы: Тиньков
преимущество: Преимущество
весна: весной Весна
происходить: Происходит
каков: Каково Какова
кейт: Кейт
архитектура: архитектур архитектуры архитектура архитектурой Архитектура архитектуре архитектуру
зарембы: Зарембы
бывало: бывало
выспаться: выспаться
бельё: бельем
бо́льшать: Бо́льшая
болеть: Болеет
криптонавт: Криптонавты
возобновлять: возобновляемым возобновляемые возобновляемых
клён: Клен
дедушкин: дедушкиного
заключение: Заключение
вернер: Вернер
вчера: вчера Вчера
ядроперезагрузка: ЯдроПерезагрузка
возможно: Возможно возможно
выбрасывать: выбрасываемой выбрасывают выбрасывает выбрасывать
ноутбук: Ноутбуки Ноутбук
зависеть: Зависит
нежный: Нежный
автоматический: автоматической автоматического автоматическими автоматическое автоматическую автоматический
сда: Сда
пожалуй: Пожалуй
анонимный: анонимной анонимных анонимные
максимально: Максимально
япония: Японии
драматично: драматично
производитель: Производитель
скриншот: Скриншот
визуальный: визуальных визуальной
сообщение: Сообщение Сообщения
гость: гостей гостями
серверный: Серверный Серверные
хаба: Хабы
проверить: Проверьте Проверенная Проверить Проверим
внутри: Внутри внутри
дюна: Дюну
сначала: Сначала
аргументированно: аргументированно
ричард: Ричарда
делиться: Делитесь делятся делиться делимся
кастомный: Кастомные
нива: Нивы Нивами Ниву
мало: Мало
дно: дна дном дно
голый: голый голые голую
номинально: Номинально
строй: Строю
батискаф: батискафом
простой: Проще Простого Простейшую Простой
бэкап: Бэкапов бэкапом бэкапа бэкапов бэкап бэкапы
линковочный: Линковочные
вышеописанный: вышеописанную вышеописанная
да: да Да
после: После
простить: Простите
совкомбанк: Совкомбанка Совкомбанк
жирный: жирное жирный
демонстрационный: демонстрационных
гуглита: Гуглите
движение: Движение движения движении
барограф: барограф
жаль: жаль Жаль
топовый: Топовыми
киллсвитч: Киллсвитчи
вынимать: вынимать
управляемый: Управляемое
кэнона: Кэнон
память: Память
результат: Результат Результаты
расшифровывать: Расшифровываем
гибко: гибко
нидерланды: Нидерланды
догадаться: догадаются догадаться догадается
оцифровывать: Оцифровывая
воля: воле воли
успех: Успех
глупый: глупый глуп глупым глупые глупых
покупка: Покупка
генератор: генераторы генераторов генераторе
станиславский: Станиславских
бензин: бензин
тревожный: Тревожные
брендовый: брендовые брендовых
атмосфера: атмосфера атмосферы
ежедневно: ежедневно
домен: домены домена домен Домены доменами
гибкий: Гибкий гибче гибкое гибкими гибких
виндовыя: виндовые
вздуться: вздувшись
впечатляющий: впечатляюще
гвоздь: гвоздями
ильф: Ильф
выразиться: выразиться
удивиться: Удивился
лишь: Лишь
наконец: Наконец
азиатский: азиатских азиатском
хедберг: Хедберга
вывоз: Вывоз
бп: БП
винчестер: винчестеры винчестерами
для: Для для
нет: Нет
разъём: Разъем
спасение: Спасение
разница: Разница
ковыряние: Ковыряния
годовой: годовом Годовая годовую
больница: больницы больнице
полный: Полная Полное Полный ПОЛНЫЙ
любопытный: Любопытный
программист: Программист Программисты
выздоравливать: выздоравливают
бить: бей бейте бить
время: время времени временем времена Время времен
ещ: Ещ ещ
ребёнок: дети детей Дети детьми детям детях
дипломный: дипломные дипломная
следующий: Следующие Следующий Следующим Следующая
возведение: возведению возведение
вызываться: вызываются
свежий: Свежая
грозить: грозит
доступ: доступом доступы доступа Доступ доступ доступе
гарантия: гарантии гарантий гарантию
возникать: возникали возникающих возникают возникало возникает
предыстория: Предыстория
аналитический: аналитических
сoub: Сoub
ведение: ведение ведения
десятилетие: десятилетиями десятилетие десятилетий десятилетия
кильдишев: Кильдишев
дальнеший: дальнешего
логический: Логическая
давность: давности
дообучить: дообучить
этап: Этапы
грустно: грустно
величина: величине величина
рунет: Рунета
гипноз: гипноза
выживаемость: выживаемость
кинзябулат: Кинзябулатов
ой: Ой
подтверждать: Подтверждаю
атлант: Атлант
естить: ещеНо
описывать: Описывает
дискриминация: дискриминации
графический: графического графическим графической графический графических
аудиокабель: аудиокабелю
дистанционный: дистанционного
хьюбераобучение: ХьюбераОбучение
образование: Образование
ник: Ника Ник
многовато: Многовато
получение: Получение
галеон: галеонов
рейтинг: Рейтинг
заказать: Заказать Заказал
далёкий: Дальше далек далекие далекой дальше
админ: админа админы
кампания: Кампания
эммета: Эммет
клиентский: Клиентской
дочерний: дочернего дочерняя
здравоохранение: Здравоохранение
показатель: Показатели Показатель
солод: Солод
а4: А4
четыре: Четыре
вникуда: вникуда
интересно: Интересно
грэм: Грэм Грэма Грэму
муратов: Муратова
небольшой: Небольшие Небольшое Небольшой
вацап: вацап
локация: Локация
демон: демон
процесс: Процесс
случай: Случаи
сигнал: Сигналы Сигнал
головко: Головко
выборка: выборка
костромской: Костромской
суровый: Суровые
директория: директорию директории
букхайта: Букхайт
кнр: КНР
видеосъ: видеосъ
блин: блин
следовать: Следует
больничный: больничными
казак: Казаков
иногда: Иногда
детализировать: детализированном
бюджет: бюджета бюджетах бюджеты
дневник: дневник
вставлять: вставлять
нурисламов: Нурисламова
депутат: депутатов
бразилия: Бразилия
безвозмездно: безвозмездно
лично: Лично
морской: Морские
верно: верно
вещание: вещание вещания вещании
десктопность: десктопности
ни: НИ Ни
токсичность: Токсичность
бедствие: бедствие
гадить: гадят
необходимый: Необходимый
инвестор: Инвесторам Инвесторы
таиланд: Тайланде Таиланде Таиланд
гипервизора: гипервизор гипервизоре гипервизорами гипервизорах гипервизора
абсолютно: абсолютно Абсолютно АБСОЛЮТНО
внутренность: внутренностями
амазона: Амазона
валидность: валидность
вполне: вполне Вполне
федерация: Федерации
сконцентрироваться: Сконцентрироваться
будто: Будто будто
винод: Винод
нью: Нью
креативный: Креативная
гомоэректуса: гомоэректусы
сравнение: Сравнение
мтс: МТС
внятный: внятных
еслич: еслич
сергей: Сергей Сергеем
вайпить: вайпить
росбанк: Росбанк
альтеренативный: альтеренативный
буквенный: буквенных
блютуса: блютуса
модель: Модель Модели
гросс: Гросс
донгнуть: донгла
клавиатура: Клавиатуру Клавиатура
асхат: Асхат
цода: ЦОДы ЦОДа ЦОДе
директ: директ
шульц: Шульц
барьер: барьером барьеры
биткоина: биткоина биткоину
скс: СКС
десктопный: десктопных десктопный десктопным десктопного десктопными десктопные
кудряшов: Кудряшовым
задать: Задайте
петербург: Петербурге Петербурга Петербург
вагон: вагоны
хасис: Хасиса
показаться: Показалось
маршрутный: Маршрутная
бэк: бэк
слишком: Слишком
выявление: Выявление
хоть: Хоть
регулярный: Регулярные
абсолютизм: абсолютизма
оставаться: Остается Оставаться
допномер: допномера
среди: Среди
граница: границы границей границу
вкл: вкл
обращать: Обращать Обращаем
ответ: Ответ
сильберман: Сильберман
запомнить: Запомните
актуально: актуально
должное: должное
вч: ВЧ
богатый: богатая богатого богатым богатые богатыми
выбрасывание: выбрасыванию
хосёл: Хосла
эбу: ЭБУ
шинкоренко: Шинкоренко
баржа: баржах
бедность: бедности
любимов: Любимов
ядерный: Ядерная
вес: весов весами вес веса весу
длительность: длительность длительностями
городской: городской
вынуждать: вынуждает
блог: блоги Блог блог блога блоге
выключиться: выключился
беларусский: Беларусский
боков: боковой боков
нагрузка: Нагрузка
судить: Судя
разобраться: Разобрались
износиться: Износились
включ: включ
гениальный: гениальные гениальных гениальной
грег: Грега
видеозапись: видеозаписей
торговый: Торговые
учёт: Учет
выжимка: выжимку
вцепиться: вцепиться
деск: деск
заряжать: Заряжать
элт: ЭЛТ
дилер: дилера
айтишник: айтишники айтишников
хельсинки: Хельсинки
участник: Участники
нко: НКО
сеанс: Сеанс
выиграть: выиграл выиграть выигранный
рабуа: Рабуа
стейнбек: Стейнбек
аггресивный: аггресивные
взгляд: взглядов взгляд
франкфурт: Франкфурте
единымязык: единымЯзык
иметь: Имейте Имея Иметь
включая: включая Включая
андройда: андройд
ро: Ро
вагиз: Вагизов
продолжение: Продолжение
вечерний: вечерним вечернее
аудит: аудите
вкус: вкусом вкус вкуса вкусах
вперд: вперде
испанский: Испанских
бут: бут
бомба: бомбой бомбу бомбы
вещательный: Вещательные
радио: Радио
архив: архивы архиве
доступно: доступно
блогер: блогера блогер блогеру
именно: Именно
тенденция: Тенденции
плей: Плея
выгорание: выгорание выгорания выгорании Выгорание
властьимущий: властьимущие
дуэль: дуэлях
раздор: Раздоры
выполняться: выполняется выполняться выполняются
взаимодействовать: взаимодействует взаимодействовать
блокировка: блокировка блокировки блокировку блокировок блокировкой
электрохимический: Электрохимическая
шамгун: Шамгунов
тестировать: Тестируемый Тестируем Тестируйте
редкий: Реже
подкаст: Подкаст
восемь: восьми восемь
баранов: баранов Баранов
член: Членам
вкладыш: вкладыш
скайнет: Скайнетом
геопространственный: геопространственные Геопространственные
близко: близко
цос: ЦОС
аргументовstart: аргументовstart
долететь: долетел
эффективность: Эффективность
алмаз: алмаз алмаза
бег: Бег
анонсироваться: анонсироваться анонсируется
румыния: Румынии
блестящий: блестящая
николай: Николай
выигрышно: выигрышно
выделение: выделением выделения выделение
коидти: Кошел
баг: бага баги багов баг багами
упаковать: Упакован
организация: Организация
бинарник: бинарники
разрешаться: Разрешалось
тб: Тб ТБ
догонять: догоняющего
действовать: действовать действовали действующей действовал действует действуем
аутентифицировать: аутентифицирует
бокс: бокс боксы
эпл: Эплу
выразить: выражено Вырази
иван: Иван
традиционно: Традиционно
запускаться: Запускалось
грусть: грусть
отсутствовать: Отсутствует
входить: входить входит входят
житель: жители жителям
выпилить: выпили выпилены выпилили выпилил выпилено
оверклокинг: Оверклокинг
воркшоп: воркшопе
прямо: Прямо
ковать: Ковал
британец: британцы
гипервизор: гипервизоров гипервизором
повышать: Повышает Повышать
филипп: Филипп
минск: Минск
минимальный: Минимальная
спб: СПб
сми: СМИ
тормозить: Тормозило
далее: д далее Далее Д
войти: вошли Войдите войти вошла вошел
дружеский: дружеское
добиваться: добивается добиваться добиваемся
радиолюбительский: Радиолюбительские
мамут: Мамутов
встраивать: встраивайте
спид: СПИД
героин: героина
текст: Текстов
грант: Грант Грантом Гранта
люксембург: Люксембург
декадный: декадно
пост: Пост
гореть: гори Гореть горящими Гори гореть
биотех: биотех
обойтись: Обошлась
расширить: Расширили Расширенные
биохимия: биохимией биохимии
немного: Немного
довольно: довольно
одноклассник: Одноклассниками
специально: Специально
вейланд: вейландом
честно: Честно
высылать: высылать
голова: головой голове головы голову Головой голова
вст: вста
биотехнология: биотехнологии биотехнологий биотехнологиям
фототехник: Фототехника
джесс: Джесс
аналогия: аналогию аналогия аналогии аналогий
десятка: десятками Десятки десяток десятки десятку десятке
вова: Вова
выкинуть: выкинул выкинут выкинуть выкинутые
висеть: висят висящих
абрамчук: Абрамчук
региональный: Регионального
бодо: Бодо
активностижёлтый: активностижелтый
комментарий: Комментарий Комментарии
белок: белков белка
высокотехнологичный: высокотехнологичной высокотехнологичная высокотехнологичных
базовость: базовости
чибрик: Чибриков
восторг: восторгов
потребность: Потребности
ботнет: ботнет Ботнету ботнеты
занять: Заняла
придумать: Придумать
конрад: Конрад
длиться: длится
взрываться: взрывается
терминатор: Терминатор
гигабитный: гигабитным гигабитный гигабитной
экран: Экран
стартовать: Стартуют
рынок: Рынок
атом: атоме
ирина: Ирина
выдавить: выдавил
детектировать: детектировать
гуандун: Гуандун
демонстрация: демонстрацией Демонстрация демонстрация демонстрации
приёмник: Приемник
разбираться: Разбирается
декомпозиция: декомпозицию
еле: еле
тошиба: Тошиба
восток: востока Востоке Востока
вылазить: вылазить вылазит
корпус: Корпусы Корпус
зря: Зря
красный: Красном Красная Красным
вышеуказанный: вышеуказанному
домой: домой
применимый: Применим
коллисон: Коллисон
гараж: Гаража
гетеродинный: гетеродинного
менеджмент: Менеджмент
охотский: Охотском
включиться: включился
донат: донаты
консультация: Консультации
впервые: впервые Впервые
годфри: Годфри
благотворительный: благотворительный
несмотря: Несмотря
башмак: башмаку башмак
допустить: допустим допущена допущенных Допустим допустить
добровольный: добровольное добровольному
сидеть: Сижу
клик: КЛИКОВ
камо: Камо
бурный: бурного бурная бурному
воссоздание: воссоздание
мессенджер: Мессенджеры Мессенджер
брокер: Брокер брокерами брокер брокеров
оператор: Оператор
биржа: биржу биржа биржах бирже бирж биржами биржи
безумный: безумной безумная
жаба: жабы жабе
тестирование: Тестирование
каролайн: Каролайн
марь: Мари
геораспределительный: геораспределительные
диагональ: диагональю
делонг: делонги
воспроизводить: воспроизводить
актуализация: актуализацию
банк: банка банки банк банкам банком Банк банками банков
дв: ДВ
вставить: вставить
выбросить: выбросьте выброшен выбросить
возраст: возрасте возрастов возраст возрастом
инженер: Инженеры Инженерам Инженер
мгц: Мгц МГц
внушительный: внушителен
дорожка: дорожка
меделяна: Меделян
обработка: Обработка
карпов: Карпов
выдерживать: выдерживал
дискретизация: дискретизации
ильин: Ильин
перерабатываться: Перерабатывается
магдалина: Магдалин
добрый: добрую доброй добром добрые доброго
шаньдун: Шаньдун
слева: Слева
глухой: глухой
баланс: балансом
википедия: Википедии википедия
воин: воин
карма: Карма КАРМУ
алекс: Алекс
благодарность: благодарностью
плагин: Плагины
вёлка: велкам
нерационально: Нерационально
здоровье: Здоровье
рогинский: Рогинский
автоматизцация: автоматизцации
докатиться: докатиться
антимонопольщик: антимонопольщики
бухать: бухал
песочницаперегрузка: ПесочницаПерегрузка
благодаря: благодаря Благодаря
вылиться: выльется
представимый: Представим
увольнение: Увольнения Увольнение
втч: втч
рассказать: Расскажут Расскажите
харихаран: Харихаран
ук: УК
довольный: довольны довольной довольными доволен
латвия: Латвия
ввоз: ввоз
вред: вред вреда
демпинговать: демпинговать
выскочить: выскочившие
еженедельный: еженедельные
хх: ХХ
пк: ПК
нобиль: Нобиле
чем: Чем
ит: ИТ
вызвать: вызвана вызвало вызванных вызвать вызовет вызвавшим
рахман: Рахман
автомобилестроение: автомобилестроения
аммона: Аммона Аммон
десктопной: десктопное Десктопное
сваричевский: Сваричевский
долгота: долготе долготу
аля: аля
негативный: Негативный
вдохнуть: вдохнет
дорофеев: Дорофеев
допаять: допаял
голос: Голос голосов голоса Голоса
выматывать: выматывает
решить: Решили Решил
тьма: Тьма
валяться: валяется
видимость: видимостью видимости видимость
нло: НЛО
влепить: влепить
дебелов: Дебелов
адреналин: адреналин
считать: Считаю
адресация: адресации адресация
достигать: достигают
избавиться: Избавимся
формат: Формат
такть: Такй
китай: Китая Китай Китае
каличкина: Каличкин
комментировать: Комментировать
кроме: Кроме
желательный: желателен
бесперебойный: бесперебойной бесперебойного
бекон: беконом
эрик: Эрик
гришин: Гришин
газоблок: газоблоки
вариация: вариации
выставлять: выставлять выставляете выставлял
внешни: внешни
потапов: Потапова
авторизированный: авторизированной авторизированного
постфактум: Постфактум
видеореклама: видеорекламы
краткий: Краткие
бартон: Бартон
билд: билд
ага: Ага
данныеобучать: данныеОбучающая
додуматься: додумались
денис: Денис
аналоговый: аналоговом аналоговый
вероятность: вероятностью вероятность вероятности
продолжать: Продолжая Продолжаю
единожды: единожды
кинуть: Киньте
паркер: Паркер
вплоть: вплоть
бедно: бедно
возле: возле
дефолт: дефолту
демпинг: демпинга
камон: Камон
вырабатываться: вырабатывается
вручную: вручную
бонд: бонд
пять: Пять
конец: Конец Конца
верна: верн
учитываться: Учитываются
центр: Центре Центр
родиться: Родилась
гранд: Гранде
сооснователь: Сооснователи Сооснователь
телескоп: Телескоп
активировать: активируют активировать
грид: грид
выпендра: выпендр
писать: Пишем Пишут Пишу
сц: СЦ
вылетать: вылетает вылетала
вёрстка: верстке верстка
услуга: Услугу
платить: Платить
доразметка: доразметки
хранение: Хранение
многоадресный: Многоадресные
саповый: Сапов
вакцинация: вакцинации
вышеобозначить: вышеобозначенным
предположим: Предположим
дорого: дорого
деньга: деньги деньгах деньгами денег Деньги деньгам
однако: Однако
дмитрий: Дмитрий Дмитрия
здравствуйте: Здравствуйте
менеджер: Менеджер
программировать: Программируем
животное: животного животное животные животных Животные животным
беспокоиться: беспокоится
доходить: доходят доходили
налетать: Налетай
одноплатник: Одноплатник
сервисный: Сервисных
даже: даже Даже
влад: Влад
гос: гос
впросо: впросу
сухаил: Сухаил
определённо: Определенно
бесполезный: бесполезен бесполезных бесполезный
над: Над
вырасти: выросли вырастет вырасти вырастут вырос
часто: Часто
безумие: безумия безумие
простоять: Простояла
макс: Макс
чтение: Чтение
бар: бар
любой: Любой
отрасль: Отрасли
провайдер: Провайдер
текущий: Текущие
длина: длиной Длина длину длины длина
увидеть: Увидел
всеволод: Всеволод
вряд: Вряд вряд
актуальность: актуальность актуальности
глушилка: глушилки глушилок
конкретно: Конкретно
вненуть: внешего
байкал: Байкал
интересоваться: Интересующиеся
программный: Программные Программное
подводный: Подводные
оптимизация: Оптимизация
бродкастер: бродкастеров
неома: Неоме
депрессиястресстлен: депрессиястресстлену
днепропетровск: Днепропетровска
также: Также
браться: брались браться
агрегатор: агрегатор
днк: ДНК
аренда: Аренда аренду аренде аренда арендой аренды
география: география
натыкаться: Натыкался
возразить: возразить
ливингстон: Ливингстон
приспособление: Приспособление
сильный: Сильные
название: Название
семья: Семья
барахольщик: барахольщики
грачик: Грачик
диверсифицировать: диверсифицированных
вслед: вслед
инна: Инна
улучшиться: Улучшились
вайп: вайп
черняк: Черняк
лечение: Лечение
вне: вне
доказать: доказала доказать Доказать доказано доказали
вещать: вещает вещала вещают
овчарик: Овчарик
предшественник: Предшественник
бабло: Бабло бабло
жилец: жильцы
выставить: выставил выставим Выставить выставить
биоуголь: биоуголь
годиться: годится
внимательно: внимательно
теперь: Теперь
вышеупомянутый: вышеупомянутого
болезнь: болезнями болезнь
генерить: генерят генерить
блоб: блоб
ловить: Ловить
номер: Номер
выявлять: выявлять
давно: Давно давно
йорк: Йорк Йорке
практика: Практика
акула: Акулы
дефицитный: дефицитным
мясо: Мясо
выкидыш: выкидыш
энтерпрайза: Энтерпрайз
волновать: волнует
заработать: Заработать
алиса: Алиса
мат: МАТ
энерджи: Энерджи
карл: Карл
вовсю: вовсю
флора: Флора
визуала: визуала визуалами
англ: англ
кирупа: Кирупа
водрузиться: водрузилось
примечание: Примечание Примечания
прежде: Прежде
альцгеймер: Альцгеймера
авторство: авторством
поставить: Поставил Поставить
достучаться: достучаться
запоминание: Запоминание
горизонтальный: горизонтальное
создание: Создание Создании
разбирать: Разбираем
возрастной: возрастные
психотерапия: Психотерапия
профессиональный: Профессиональное
влияние: влияния влияние
барабан: барабанами
врать: врать
действительность: действительности
атака: атаки атак
возить: возить
бутылка: бутылкой
ассистент: ассистентов ассистента
софия: София
бесмыссленный: бесмыссленна
воспитанный: воспитан
конкурс: Конкурс
пма: ПМа
дть: демо
вогнать: вогнали
структурирование: Структурирование
бороться: борется бороться борешься борются
снять: Снял
выделяться: выделяется выделяющимися выделяются
взвинчивать: взвинчивать
дозвониться: дозвониться
выключаться: выключался выключается
добираться: добирались
двузначный: двузначным
дескриптор: дескрипторы
вторгаться: вторгается
министерство: Министерство
дм: ДМ
удешевление: Удешевление
кейшева: Кейшев
фабричный: Фабричная
данна: даннам
супер: Супер
допуск: допуска
воркер: воркеров
десятикратно: десятикратно
веб: вебом Веб веб вебе
смартфон: Смартфоны
хабра: Хабру Хабре Хабр Хабра
евро: евро
подразумеваться: Подразумевается Подразумеваются
выхлоп: выхлопа
сибель: Сибель
взаимный: взаимным взаимное взаимного
жестоко: жестоко
московитц: Московитц
норвегия: Норвегия
анроидный: анроидные
григорий: Григорий
концепция: Концепция
глупость: глупости глупость
армения: Армения
вырубка: вырубки
декларация: декларация деклараций декларации декларацию
озвучить: Озвучь
дц: ДЦ
плавать: ПЛАВАЕТ
геморрой: геморроя геморрой
водный: водных водный
мексика: Мексику
джереми: Джереми
численность: Численность
анти: анти
бесплодие: бесплодие
неужели: Неужели
валидация: валидации валидацию
крэйга: Крэйг
демотивация: демотивацией
иеремий: Иеремии
глубокий: глубокая глубокого глубокие глубокой глубоких глубокое глубже
билинга: билингу
дцать: дцать
гц: Гц
отличный: Отличное
постепенно: Постепенно
всерьёз: всерьез
домовсамый: домовСамый
женя: Женя
чёска: Чески
железяка: железяках
апокалипсис: апокалипсис
криптовалюта: Криптовалюты
невозможно: Невозможно
жильё: жилье жилья жилью
амбиция: амбиции
активность: активности активность
аут: аута
казаться: Кажется Казалось
ворда: ворд
десятипальцевый: десятипальцевым десятипальцевого
дорожный: дорожном дорожной
атаковать: атакующий
сбпчего: СБПЧего
воздух: воздух воздуха
производство: Производство
дальность: дальность
при: При
питер: Питере Питер
хейл: Хейл
изучение: Изучение
глеб: Глеб
слияние: Слияние
дохнуть: дохли
видение: видение видением
дурачок: дурачка
картинка: Картинки Картинка
распределённый: Распределенные Распределенная Распределенный
нескучный: Нескучные
идея: Идея
гладкобородов: Гладкобородовы
винтик: винтиками винтики
сервис: Сервис Сервисы
обратить: Обратите
открыто: Открыто
эмбеддинг: Эмбеддинги
подключаться: Подключаюсь
дискретный: дискретной дискретную
аутентфикация: аутентфикацию
отстрелиться: Отстрелился
количество: Количество
бетонный: бетонный
ханчжоу: Ханчжоу
уорбить: Уорби
выдержать: выдержал
годытак: годытак
блобов: блобов
никто: Никто
дудчук: Дудчук
азербайджанский: азербайджанский
статистика: Статистика
байтовый: байтового
дохлый: дохлые
вирусный: вирусными
высвободиться: высвободившийся
представить: Представьте Представили
вставать: вставал Встает
проект: Проект Проекты
написание: Написание
деньжискать: деньжища
эйфелевый: Эйфелевых
тема: Тема Темы
существовать: Существуют Существует
втихую: втихую
двусторонний: двустороннее
контур: Контур
странный: Странный Странная
клаудрэдить: Клаудрэди
внедряться: внедряться
водиться: Водится водились
скопировать: Скопировать
даташит: даташитов
теслюк: Теслюк
китаец: Китайцы
задонатить: Задонатить
контроллер: Контроллеры Контроллер
полноценный: Полноценная Полноценное
выпить: выпить
вместить: вместить
втб: ВТБ
вписываться: вписывается
белич: Белич
подробность: Подробности
альстромер: Альстромер
жанр: жанре жанра
чип: Чип Чипы
отпугнуть: Отпугнула
косово: Косово
хакатон: Хакатоны
брутфорс: брутфорс
вспоминать: Вспоминай Вспоминаем
присоединиться: Присоединившись
определить: Определить Определите
восхище: восхищ
кб: КБ
корутина: Корутины
шир: Шир
диктовать: диктуют
хотеться: Хочется Хотелось
шеннон: Шеннона
кит: Кит Киты
некорректный: Некорректный
выловить: выловить
априори: априори
дохленький: дохленький
филиппина: Филиппины
внести: внесено внести
использование: Использование
австралия: Австралия Австралии
выдаваться: выдавались выдаются
ужаснуться: Ужаснулся
жетон: жетонов жетон Жетон
взаимозаменяемость: Взаимозаменяемость
тайвань: Тайване
башка: башкой
абзац: абзаце
пчелиный: Пчелиные
прочий: Прочие
значит: Значит
британия: Британии
кндр: КНДР
запускать: Запускает
тат: Тат
габарит: габаритов Габариты
близь: близи
проанализировать: Проанализируйте
тянуться: Тянуться
микроконтроллер: Микроконтроллер
недостаток: Недостаток
видный: виден видна
схд: СХД
лондон: Лондоне
буря: бурь
данный: данный данном данную Данный данного
шотландия: Шотландии
выращивание: Выращивание выращивание выращивания
коммутатор: Коммутатор
недавний: Недавние
багтрекер: багтрекер
бюрократия: бюрократии
билл: Билл
ама: АМ
жк: ЖК
песочницакака: ПесочницаКак
полуоткрытый: Полуоткрытый
декорация: декорацию
диана: Диане
вызывающий: вызывающей
гамма: гамме
бездисковый: бездисковой
северо: Северо
значительный: ЗНАЧИТЕЛЬНАЯ Значительную Значительная
аккумулировать: аккумулировать
мигиковский: Мигиковский
автоматическименять: автоматическиМеняет
мак: Мак Мака
демонстрировать: демонстрируют демонстрируя демонстрирует
азартный: азартную
запас: Запасы
докинуть: докинуть
маша: Маша
технология: Технологии Технология
греция: Греции
чистый: Чистая
диабет: диабетом диабету
тезисный: Тезисная Тезисное
эмоциональный: Эмоциональное Эмоциональный
криптоархеолог: Криптоархеологи
буровой: буровой
проблема: Проблем Проблемы Проблема
автономный: автономный автономные автономного автономной автономном
плюс: Плюс
калининград: Калининграде
естьд: естьДа
чуть: Чуть
кей: Кей
брутян: Брутян
затрата: Затраты
благополучно: благополучно
читаемый: Читаем
сue: Сue
савватеев: Савватеева
прокрастинация: Прокрастинация
ашбахер: Ашбахер
автономно: автономно
воронеж: Воронеже
герман: Герман
запрет: Запрет
берзарина: Берзарина
еммс: еММС
тилек: Тилек
выбраковка: выбраковки
мизотин: Мизотин
поуп: Поуп
сеть: Сеть Сети
поддерживать: Поддерживает
понадобиться: Понадобится
голубой: голубой
аплодисменты: аплодисментов
хаффман: Хаффман
сделка: Сделка
ездить: ездите
болезненный: болезненное болезненная
ставить: Ставить
тяньцзинь: Тяньцзинь
чужой: Чужие
творчество: Творчество
спонсорство: Спонсорство
поведение: Поведение
макинтош: Макинтоша
неизвестно: Неизвестно
законодательство: Законодательство
ес: ЕС
декондинга: декондинг
пламя: Пламя
густав: Густав
багованная: багованные
армянин: армян
бог: бог богу Бога
скорый: Скорая
де: де
геномик: геномика
воспринимать: воспринимаю
маньялак: Маньялак
госкомпания: госкомпании
заключительный: Заключительные
стоп: Стоп
интересный: Интересными Интересное
простота: Простота
агрессивно: агрессивно
анимационный: анимационный
групповой: групповых групповые
большинтсва: большинтсве
роман: Роман
высадка: высадки
ехать: ехать едет
код: Код
яп: ЯП
вольный: вольны
предполагаться: Предполагается
гуглосервис: гуглосервисы гуглосервисов
сессия: Сессии
акселератор: Акселератор акселераторе акселератор акселератора
написать: Написано
контрибьюшн: Контрибьюшн
абстрактный: абстрактном абстрактный
знакомство: Знакомство
вдохновение: вдохновением
девать: девать
немецкий: Немецкие
переработка: Переработка
анализатор: анализатора
дилерский: дилерских дилерский дилерское дилерские
процедура: Процедура
самокат: Самоката
скорее: Скорее
выяснять: выясняли
покопаться: Покопавшись
объём: Объем
высокоростный: высокоростным
задача: Задачи Задача
московский: Московская
ничего: Ничего
бенчмарков: бенчмарков
выражаться: выражаться
времязатрата: времязатраты
брэдить: Брэди
жилой: жилых жилой
ежемесячный: ежемесячного
апология: Апология
мчс: МЧС
взвесить: взвесить взвешенными взвешенной
впаять: впаянным
ембеддедный: ембеддедные
бесконечно: бесконечно
дерек: Дерека
наём: Найм
добавляться: добавляется добавляться добавляются
должность: должность
мамонт: Мамонты
говядина: говядины
дамп: дамп
вырезать: вырезаем
инженерный: Инженерные Инженерный
прид: Прид
завершать: Завершает Завершайте
официальный: Официальная
изучить: Изучив Изучите
мороз: Мороза
ксения: Ксения
сталкер: Сталкера
куйд: Куйда
иметься: Имеется Имеются Имелось
диагностироваться: диагностируется
ловля: Ловля
домик: домик
обсуждать: Обсуждают
онтол: Онтол
деплоиться: деплоиться
врождённый: врожденных
российский: Российский
прикольно: Прикольно
кальмагаев: Кальмагаев
характеристика: Характеристики
выемка: выемки
вперёд: вперед
вечно: вечно
аккуратный: аккуратное
абонент: абонентов абонентами абонента
единообразный: единообразным
гарри: Гарри
рекрутинг: Рекрутинг
оболочка: Оболочки
составлять: Составляющих
вести: ведет ведут вести
посоветовать: Посоветовал
доминтернет: доминтернет
насколько: Насколько
михаил: Михаила Михаил
ничто: Ничто
удержать: Удержать
ранее: Ранее
интеллектуальный: Интеллектуальная
гаджетымусорэлектронный: гаджетымусорэлектронные
дея: дей
планшет: Планшеты
корректный: Корректный
крышка: Крышка
робот: Робот Роботы
выписывание: выписывания
больно: больно
грамотно: грамотно
безоговорочно: безоговорочно
фото: Фото
клиент: Клиент Клиенты
больша: большу
видеовывод: видеовывода
постановка: Постановка
оон: ООН
педалька: Педальку
вороток: воротков
системный: Системный Системное
битовый: битовой Битовый Битовое битовых
разблокировка: Разблокировка
глобально: глобально
очередь: Очереди
ирландия: Ирландия
право: Права Право
дорогущий: дорогущего
жный: жный
грузить: грузит
компьютерный: Компьютерная Компьютерное
машина: Машины Машина
допускать: допускали допускать
доводить: доводить
передаваться: Передается
пустота: Пустоту
незначительно: Незначительно
балансировать: балансирующая
вынуть: Вынуть
госпиталь: госпитале
аккумуляторный: аккумуляторной
миссия: Миссия
вера: вера
завтрак: Завтрак
миранда: Миранда
дыра: дыры дыру
опциональный: Опциональные Опциональная
военкомат: военкоматах
цена: Цена
премьер: Премьер
бош: боша бош
перед: Перед
башня: башен
интроспекция: Интроспекция
вечером: вечером
стюарт: Стюарт
интерфейс: Интерфейс Интерфейсы
нетривиальный: Нетривиальные
биологический: биологической Биологические
сoob: Сoob
бахтин: Бахтина
где: Где где
проблемный: Проблемные
баловство: баловство
субъективно: Субъективно
аниме: аниме
всеволновый: всеволновые
бадди: Бадди
предприятие: Предприятие
степень: Степень
советовать: Советую
вливаться: вливается
желудок: желудком
брильянт: брильянты
скибинский: Скибинский
руслан: Руслан
август: августа август
всевозмножный: всевозмножные
до­ли­ич: До­ли­ны
просто: Просто
вымирать: вымирающего
извинить: Извини
генерал: генералы
саша: Саша
виндоуса: виндоусу
жалеть: жалею жалеют
татьяна: Татьяна
юурга: ЮУрГУ
гб: гб ГБ Гб
остин: Остин
дословно: дословно
спросить: Спросите
киргизия: Киргизии
био: Био
визуализация: Визуализация
стив: Стива Стив
загрузить: Загрузить
весело: весело
бибиси: БиБиСи
гуманно: гуманно
авить: авито Авито
осторожно: Осторожно
уфф: Уфф
повториться: Повторюсь
дашборд: дашборд
депрессивный: депрессивных
слак: Слака Слаке Слаки
научно: Научно
глотать: глотать
курышев: Курышев
маска: Маска
буфер: буфере буфера
метеофакс: Метеофакс
джастин: Джастин
аналог: аналоги аналог аналогом аналогов
вероятностный: вероятностное
готовность: готовности
пккомпьютер: ПКкомпьютеры
подсеть: Подсеть
гигант: гигантов
когнитивный: Когнитивные
деградировать: деградирует
иб: ИБ
апп: аппе
всевозможный: всевозможные
видеонаблюдение: видеонаблюдения
диктофон: диктофон
выводым: выводыМы
фунция: Фунция
частотный: Частотная Частотное
правка: Правка
митч: Митча
имбирь: Имбирь
эксперт: Эксперты
армия: армия
бежать: бежать беги
силиконовый: Силиконовая
спонсировать: Спонсируемое
удивительно: Удивительно
гайдов: гайдов
вкорячить: вкорячил
надо: Надо
дубляжом: дубляжом
гермации: Гермации
шкредов: Шкредовым
аттенюатор: аттенюатор аттенюатора
вкалывать: вкалывать
рожин: Рожин
класс: Класс
увы: Увы
воздействие: воздействия воздействие
ангела: ангела
диагностик: диагностику
дефолтной: дефолтной
выкупать: выкупает
энтузиаст: Энтузиаст
стыд: Стыд
св: СВ
ставиский: Ставиский Ставиского
поговорить: Поговорим
возникновение: возникновении
авторизация: авторизации авторизация
матео: Матео
действительно: действительно Действительно
грядущий: грядущие
гэри: Гэри
аналитика: аналитика Аналитика
выд: выда
назвать: Назвать
остап: Остап
создатель: Создатель Создатели
кокорич: Кокорич
экология: Экология
дельта: дельта дельту дельте Дельта
свой: Своими Свой Свои
влечий: влеч
вооружённый: вооружен
станция: Станции
рано: Рано
бутик: бутиков бутик
серьга: Серьги
улучшение: Улучшение
диссоциироваться: диссоциироваться
впереди: впереди
дайджестсетевой: дайджестсетевые
поставщик: Поставщик
подписчик: Подписчики
гуглиться: гуглятся
стрелять: Стреляем
прим: Прим
выбыть: выбыл
вынести: вынести вынесли вынесена вынесено
экзамен: Экзамен
авторский: Авторские авторском авторским авторская
дофамин: дофамина
руководитель: Руководитель
отслеживать: Отслеживайте
учёный: Ученые
сямынь: Сямынь
гибралтар: Гибралтар
новость: Новости
лермонтов: Лермонтов
активно: активно Активно
бортовый: бортовые
достаточно: Достаточно достаточно
военка: военки
ботаодный: ботаОдной
вселенная: вселенных
апрель: апреля
средиземный: Средиземного
дем: деме дем
джейсон: Джейсон
про: Про
аппратный: аппратной
стабильный: Стабильные
везение: везения
продаваться: Продаются
неприятность: Неприятность
ггц: ггц
милый: Милые
размещение: Размещение
булавка: булавка
гугол: Гугол
вправду: вправду
оу: ОУ
гель: гелем гель
пфлопс: Пфлопс
гугловский: гугловское гугловские
артур: Артур
герц: герц
причина: Причины Причина
юридический: Юридические Юридическая
рубен: Рубен
противовыбросовый: Противовыбросовое
площадь: Площадь
инструмент: Инструменты
вынудить: вынуждены
непонятно: Непонятно
баттэрфилд: Баттэрфилд
журналист: Журналисты журналистов журналистами
авто: авто
пользователь: Пользователи Пользователям Пользователь Пользователю
вкладывать: вкладывают
алтернативный: алтернативную
скрипт: Скрипт
дудочник: Дудочник
ната: Нату
дрянный: дрянные дрянной
у: У
форум: Форумы
полёт: Полет
устройство: Устройство
досихпора: досихпор
напомнить: Напомнить
хахун: Хахунов
естно: естно
вьетнам: Вьетнам
распредел: Распредел
динамичность: динамичность
трассировка: Трассировка
зачем: ЗАЧЕМ Зачем
джеить: джеил
средний: Среднее
требование: Требования
шесть: Шесть
выбить: выбить
стать: Стали
утилита: Утилита
чэнд: Чэнду
деполтной: деполтной
альфред: Альфред
глянуть: гляну глянуть Гляньте
гипнотерапия: гипнотерапию
конкрентный: Конкрентно
высококонтрастный: высококонтрастную
гримаса: гримасу
гудок: гудки
вестерн: вестерн
артефакт: артефакты артефактом артефактов
алкогольный: алкогольную
департамент: департамента
сценарий: Сценарий
видимо: Видимо видимо
проц: Проц
демонтаж: демонтаже
сша: США
промокод: Промокод
бекап: бекапы бекапов
граничный: граничные
владимирович: Владимирович
кейс: Кейсы Кейс
джет: джета
зак: Зак
волк: волк
итоговый: Итоговая Итоговый
нии: НИИ
заботиться: Заботиться
воспроизводиться: воспроизводиться
человек: Люди Человек Людям
дымый: Дымо
аджамян: Аджамян
автоматика: автоматики
гном: гноме
вдоволь: вдоволь
виндов: виндовых
совсем: СОВСЕМ
декодирование: декодирование декодирования
вендинговый: вендинговые
ченг: Ченг
отношение: Отношение
выезд: выездом
ассортимент: ассортименте
разработчик: Разработчики Разработчик
сбп: СБП
блобах: блобах
левон: Левон
популярный: Популярным Популярной
бирка: биркой
сегодня: Сегодня
безграничный: безграничны
размышление: Размышление
выпивать: выпиваю
бригада: бригад
производительность: Производительность
вмешательство: вмешательством вмешательства
рассказывать: Рассказываем
би: Би
просмотр: Просмотры
американец: американцев американец
самостоятельный: Самостоятельное
солоницын: Солоницын
дорогостоящий: дорогостоящими
всё: Все все
выборочный: выборочного
измайлов: Измайлов
вытащить: вытащить
кротов: Кротову
освежить: Освежим
следить: Следите
ссср: СССР
получать: Получаем
гонконг: Гонконг
аппаратура: аппаратуру аппаратуры
крайне: КРАЙНЕ
докуметация: докуметация
б: б Б
весы: весам
корневой: Корневой
добиться: добиться добились
маск: Маск
много: МНОГО
громадный: громадной громадного
нигде: Нигде
выстраивание: выстраивания
выговаривание: выговаривания
выделиться: выделятся выделиться
уверенный: Уверен
нередко: Нередко
желаемый: желаемая
вписать: вписать
девочка: Девочка
градирня: градирен
аааааа: аааААА
коллектор: Коллектор
жник: жники
основной: Основной Основные
декодер: декодер декодером
водоросль: водорослях
говорящий: говорящего
анджело: Анджело
метеотелетайп: Метеотелетайп
ана: Ану
королева: Королеве
вслепую: вслепую
амстердам: Амстердаме
бочка: бочка
гиковскай: гиковская
народ: Народ
доклад: докладов
конфигурация: Конфигурация
добро: добра добро
защита: Защита
арон: Арон
вопиять: вопиющий
долголетие: Долголетие
гораздо: гораздо
калдуэлла: Калдуэлл
евросоюзилона: евросоюзилон
обычно: Обычно
то: То
предусматриваться: Предусматривается
михаилович: Михайлович
белянкин: Белянкин
хардварный: Хардварное
игрок: Игроки
греть: греет
десктопном: десктопном десктопному
три: Три
сколько: Сколько
авторитетный: авторитетный авторитетных
малиновый: Малиновая
магнитный: Магнитные Магнитная
деменция: деменция
одноплатный: Одноплатные
рекомендательный: Рекомендательные
джинсы: джинсы
естьединственный: естьЕдинственное
биполярка: биполярка
математик: Математика
почти: Почти
ну: Ну
старое: Старое
бритва: бритвой
расшифровка: Расшифровка
кто: Кому Кто Кого
луна: Луною
государственный: государственные государственного государственным Государственный
выставление: выставления
вовлекать: Вовлекайте вовлекают
ароматный: Ароматный
менее: Менее
медленно: Медленно
выполнение: выполнения выполнением выполнение выполнении
бомбардировка: бомбардировка
разрешение: Разрешение
четвёртый: Четвертое Четвертый
браузинга: браузинг
съ: Съ
учитывать: Учитывая
журнальный: журнальных
преувеличивать: Преувеличивай
тепло: Тепло
децентрализация: децентрализация децентрализации
бродить: бродил
вырваться: вырвались вырваться
диагноз: диагнозом
разбор: Разбор
учебный: Учебный
вовлечение: вовлечение вовлечением
выниматься: вынимается
сагал: Сагалов
общепринятый: Общепринятое
громкость: громкость
сравнивать: Сравниваем
выключатель: выключателем выключателей
куча: Куча
техас: Техасе
аварийный: аварийного
радовать: Радует
сорри: Сорри
гарантийный: гарантийных гарантийным гарантийный
втыкать: втыкаете
гайда: гайд Гайд гайду
балл: баллов
возрастать: возрастают возрастающей Возрастающая возрастает
диаграмма: диаграмму диаграммы
дистрибутивоа: дистрибутивоа
вячеслав: Вячеслав
ж: ж
угу: Угу
вкинуть: вкинуты
вейлэнд: вейлэндом
шум: Шум
порог: Порог
история: История
анкета: анкет
двухканал: двухканал
речь: Речь
вывозиться: вывозится
выдающийся: выдающийся
вынужденный: вынужденная
девятый: девятое
представитель: Представитель
палец: Пальцем
джон: Джон Джона
петров: Петров
курочкин: Курочкин
подавлять: Подавляющее
айфон: айфоны айфоне айфона айфонах
содержать: Содержит
искать: Ищу Ищите
вопросик: вопросик
волшебный: Волшебный волшебной волшебные
подвид: Подвид
автоматически: автоматически
ситуация: Ситуация
обезьяна: Обезьяна
гик: гика гики гикам гиков
применение: Применение
геймификация: геймификацию Геймификация
жёстко: жестко
кум: Кум
совершенно: Совершенно
юра: Юра
водородный: водородной водородные
кв: КВ
взыскивать: взыскивать
временами: временами
тайп: Тайп
дерзкий: дерзкого
заявка: Заявку
механизм: Механизм
уэльс: Уэльсе
видеочат: видеочатов
способ: Способ
спрашиваться: Спрашивается
глупо: глупо
обзор: Обзор
двадцать: двадцати двадцать
выплачиваться: выплачивается
фонд: Фонд
вым: вым
ген: гены
днепр: Днепра
довести: довести
котельников: Котельникова
дизайнразработка: дизайнРазработка
триллионный: Триллионные
моз: МОЗ
биофидбэк: биофидбэк
работа: Работа Работы
браковать: бракованные бракованных
черта: Черт
геймерский: геймерские
максимум: Максимум
мвт: МВт
каспий: Каспии
филиппины: Филиппин
вдохновлять: вдохновляет вдохновляем
хьюбер: Хьюбера
ивановский: Ивановскую
реализация: Реализация
блокировать: блокировать
трафик: Трафик
выкрутить: выкрутить
песочницаести: ПесочницаЕсли
можно: Можно
филип: Филип
активизироваться: активизировались
желающийконтактный: желающийКонтактная
базар: базары базарах базаров
дагнуть: Дагни
свитч: Свитчи
презентация: Презентация
поблагодарить: Поблагодари
сименс: Сименсу
документация: документация документации
проследить: Проследим
бвз: бвзе
широкий: Широкий Широкая
внезапно: внезапно Внезапно
выборочно: выборочно
вин10: вин10
бустинг: бустингом
разделить: Разделить
фабрис: Фабрис
фстэк: ФСТЭК
одежда: Одежду
функциональный: Функциональная
зы: ЗЫ
роботизированный: Роботизированные
оптимальный: Оптимальной
дэвид: Дэвид
договорный: Договорная
ацп: АЦП
двигатель: двигателя двигателем
фогельс: Фогельс
офис: Офис
паблик: Паблик
вебверсия: вебверсии
ричардсон: Ричардсон
рифяк: Рифяк
бельгия: Бельгии
высоковольтный: высоковольтные
вулкан: вулкана
операционный: Операционная Операционные
экстримальный: Экстримально
отпуск: Отпуск
бесчисленный: бесчисленных бесчисленные
дэниэл: Дэниэл
фз: ФЗ
дарина: Дарина
откроить: Открою
отк: ОТК
необходимость: Необходимость
хр: ХР
энергетика: Энергетики
технопарк: Технопарке
благополучие: благополучия благополучие
терапевт: Терапевты
отремонтировать: Отремонтировать
распродажа: Распродажа
вериться: верится
только: Только
запад: Запад
сотрудник: Сотрудник Сотрудники
дискуссия: дискуссии
бессмертный: бессмертны
немго: Немго
безобидно: безобидно
репетитор: Репетитор
впоследствии: впоследствии
синдром: Синдром
николаев: Николаева
виральность: Виральность
предоставить: Предоставить
аликронштейн: алиКронштейн
путь: Путь
тк3: ТК3
купить: Купил
забрать: Заберут
миша: Миша
продуктивность: Продуктивность
лимбический: Лимбическая
литцендрат: Литцендрат
обед: Обед
фортран: Фортране
добровольно: добровольно
вдохновляться: вдохновляемся
бельгиец: Бельгийцы
эмоция: Эмоции
гонимый: гоним
девайсый: девайсо
влечь: влекущих
шинкаренко: Шинкаренко
блевотина: блевотины
долгополов: Долгополов
игорь: Игорь
вакцина: вакцины
гладкобород: Гладкобородов
афганистан: Афганистан
партн: Партн
декодироваться: декодироваться декодируется
греф: Греф
светлана: Светлана
здесь: Здесь
пережить: Пережило Пережить
собрать: Собрал
вэйлэнд: вэйлэнд вэйлэнде
подходящий: Подходящих
возмутиться: возмутится
единорог: единорогов
интел: Интеле
служба: Служба
твитер: Твитер
дизайн: Дизайн дизайн дизайном
вадалаз: вадалазов
диджитальное: диджитальном
бессмысленность: бессмысленность
вынимание: вынимании
пул: Пулы
гусев: Гусевым Гусев
анатомия: анатомией
вольт: Вольт
альтман: Альтман
азия: Азии
вымываться: вымываешься
ульяна: Ульяна
алан: Алан
распаковка: Распаковка
бах: Бах
исследование: Исследование Исследования
стремительный: Стремительный
новичок: Новичкам
кипр: Кипр
чулан: Чулан
прирост: Прирост
дед: Деда
глоток: глотком
минус: Минус
гуловой: гуловой
дешифратор: дешифратор
кэт: Кэт
безделушка: безделушки
конечно: Конечно
контейнер: Контейнер
образовательный: Образовательная Образовательные
русь: Руси
доп: доп
гугловой: гуглового
век: веке век века
будильник: будильник
аббревиатура: аббревиатуры
возврат: возврата
выдвижной: Выдвижные
диссонанс: диссонанс
ежегодно: ежегодно
плотник: Плотников
роскошь: Роскошь
расписание: Расписания Расписание
илья: Илья
брижда: брижде
гу: гу
карта: Карт
вклад: вклад
пэрис: Пэрис
декларировать: декларируемому
дикость: дикость
подробно: Подробно
хоффман: Хоффман
аватарка: аватарок
ветроэнергетика: ветроэнергетика
страх: Страх
релиз: Релиз
хром: Хром Хрома
бох: бох
взрывной: взрывными
чунцин: Чунцин
коллинсон: Коллинсон
хилтон: Хилтон
заговор: Заговор
аршинов: Аршинов
увеличить: Увеличена
потом: Потом
тогда: Тогда
хэбэя: Хэбэй
лаборатория: Лаборатории
удобный: Удобные
пташникнуть: Пташник
любительский: Любительские
франкенштейн: Франкенштейн
вица: вице
игровой: Игровые Игровой
хорошо: Хорошо
анонсирование: анонсирования
водовоз: Водовозов
влупить: влупить
виртуалка: виртуалке
проголосовать: Проголосовали
динамик: динамиков
аксить: Акси
безобидный: безобидный
межанский: Межанский
драйв: драйв
получиться: Получившийся
деплый: деплой
хартман: Хартмана
аравийский: Аравийский
высиживать: высиживая
кдпть: КДПВ
аааа: Аааа
влазить: влазить
копирайт: Копирайт
ангельский: ангельский
актуализировать: Актуализированы
обновление: Обновление
анархичный: анархично
ярослав: Ярослав
вторичность: Вторичность
жительство: жительства
ворчун: ворчуны
ибп: ИБП
соответственно: Соответственно
поддержать: Поддержу
аутсорсинг: аутсорсинга
цюрих: Цюрихе
поиск: Поиск
стартап: Стартап Стартапы
очевидный: Очевидно
улыбаться: Улыбайся
балмера: Балмера
гигиена: гигиены
новосибирск: Новосибирске
отлично: Отлично
подключение: Подключение
со2: СО2
платформа: Платформа
встать: встало
карьерный: Карьерные
подготовка: Подготовка
основатель: Основатель Основатели
воплощаться: воплощаются
вбросить: вбросил Вброшу
ольга: Ольга
ильдар: Ильдар
дважды: дважды
слушайте: Слушайте
криптоигра: Криптоигры
видео: видео Видео
жаббер: жаббер
переходить: Переходим
бер: бер
йцукен: ЙЦУКЕН
постараться: Постараюсь Постарайтесь
ссылка: Ссылки
ээг: ЭЭГ
санкт: Санкт
сео: СЕО
мп: МП
каско: КАСКО
жуков: жуков
бентама: Бентама
аквалангист: аквалангиста
вводный: вводных
аватар: Аватар
брамирок: БРАМИРКА
принимать: Принимая Принимаем Принимаемый
впадать: впадал
видеокамера: видеокамеры
аптайм: аптайме
разбивать: Разбивают
час: Час
бегать: бегает бегать
действительный: действительная
скорость: Скорость
сознание: Сознание
вежливый: вежливым вежливо
антибиотик: антибиотиков
завершение: Завершение
конспирология: Конспирология
букет: букет
древовидный: древовидной
вебинар: вебинара вебинар
выходец: выходец
кудияр: Кудияров
свободный: Свободных
ральстон: Ральстона Ральстон
удача: Удачи
ликнесс: Ликнессом
специальный: Специальный
враг: враг
выкидывать: выкидывать
распределение: Распределение
канада: Канада
оз: ОЗУ
фреймворк: Фреймворки
магия: Магия
переходник: Переходник
точный: Точное Точную
переизобретать: Переизобретаем
владимир: Владимир
доставаться: достается
игра: Игры Игра
сбола: СБОЛа
восстановиться: Восстановиться
двор: дворе
вкусный: вкусные
наверняка: Наверняка
накопитель: Накопители
никита: Никита
выражать: выражать
адаптироваться: Адаптироваться адаптировался адаптироваться
криптография: Криптография
автотест: автотестов
имхо: Имхо
фаззинга: Фаззинг
аравия: Аравии
антивирус: антивирусы
детокс: детокс
буффера: буффер
эвм: ЭВМ
омар: Омаров
грузиться: грузиться грузится
панорамный: Панорамный
кан: Кан
гора: гору горы
колдуэлл: Колдуэллом
догма: догмам догмами
фурье: Фурье
возьма: возьм
рик: Рик
демодуляция: Демодуляция
тейлор: Тейлора
обладание: Обладание
увб: УВБ
размер: Размер Размеры
понять: Понять
энергия: Энергия
спокойный: Спокойный
визитный: визитная
анонс: анонсы
азарт: азарта
выздороветь: выздороветь
типичный: Типичным
вроде: Вроде вроде
аклесератор: аклесератор
закон: Закона
пм: ПМ
авитоантенна: авитоАнтенна
отключение: Отключение
вторник: вторник
сумма: Сумма
соединить: Соединенных
посыл: Посыл
влезть: влезть
таггерт: Таггерт
морзе: Морзе
максимальный: Максимальный
гостевой: гостевой гостевая
бен: Бен
например: Например
брендовость: брендовости
доминировать: доминировать
инклюзивный: Инклюзивное
воспоминание: воспоминаний воспоминания
среда: СРЕДАМ
разочароваться: Разочаровался
янцзы: Янцзы
раунд: Раунду
м: М
главред: главреда
обучение: Обучение
захотеть: Захотели
глюк: глюков глюками
наиболее: Наиболее
жизнеспособность: жизнеспособность
благосостояние: благосостояние
акция: акции акций
винда: виндой
валентин: Валентин
морозов: Морозов
пакет: Пакет Пакеты
практически: Практически
созд: Созда
слышимость: Слышимость
майка: Майки
менять: Меняя
кардашьян: Кардашьян
отдать: Отдать
несколько: Несколько
сон: Сон
режим: Режим
дурак: дураки
оно: Оно
и: И
соломон: Соломон
структура: Структура
амплитудный: амплитудной
вовлечённость: вовлеченности вовлеченность
фактически: Фактически
лыфарить: Лыфарь
гладко: гладко
думик: Думик
жертва: жертвами
тесло: Тесла
примерно: Примерно
блёклый: блеклые
алик: алике
пролежать: Пролежало
работодатель: Работодатель
амплитуда: амплитуду
лгбт: ЛГБТ
берегуочень: берегуОчень
смартофон: Смартофон
технический: Техническая
размещать: Размещать
тимофеев: Тимофеев
видищева: Видищева
должностной: должностной
система: Система
инфраструктура: Инфраструктура
дивиденд: дивиденды
френкель: Френкель
ноут: Ноут
концев: Концевой
вовремя: вовремя
спектр: Спектр
шэньчжэнь: Шэньчжэнь
миллениал: Миллениалы
точно: Точно
почему: Почему
гонка: гонке гонку
временно: Временно
звонок: Звонки
эппл: Эппл
деваться: девается
ян: Ян
нельзя: Нельзя
кормление: Кормление
открыть: Открыть
докстанция: докстанций
высокоскоростной: высокоскоростных
бенчмаркий: бенчмарком
фуджевский: Фуджевскими
цветочный: Цветочная
мемуса: Мемус
ёмкий: емкую
карло: Карло
мария: Мария
выкладка: выкладкой
урок: Уроки
же: же
дастина: Дастин
дверь: двери
классный: Классные
бюджетка: бюджетках
разработка: Разработка
подчинение: Подчинение
губительный: губительный
чиновник: Чиновники
дурацкий: дурацкий
г: г
сфотографировать: Сфотографировать
халимович: Халимович
радиоприёмник: Радиоприемник
или: Или
закрытый: Закрытым
ларионов: Ларионов
сан: Сан
влажный: влажной
вдруг: вдруг
деревня: деревне
дуся: дуся
второе: второе Второе
процитировать: Процитирую
гостиничный: гостиничных
гордо: гордо
помнить: Помните Помню
всамделишный: Всамделишная
горизональный: горизональный
позиционирование: Позиционирование
видос: видос
встройка: встройку
сейчас: Сейчас
ди: Ди
кстати: Кстати
малоизвестный: Малоизвестный
вообще: Вообще вообще
махьяр: Махьяр
к: К
пегий: Пегий
суэцкий: Суэцким
зато: Зато
восьма: восьм
буквально: буквально Буквально
азиатски: азиатски
сибел: Сибел
исходный: Исходные
выя: вые
программирование: Программирование
копнуть: Копнем
икт: ИКТ
рассмотреть: Рассмотрим
повезти: Повезло
штейн: Штейн
расширение: Расширение Расширения
ответить: Ответить Ответят
выкупить: выкупленной
жестокий: жестока
бессмысленный: бессмысленна
залоговый: Залоговое
айпад: айпад
выкручивать: выкручивать
впихнуть: впихнули
исключительно: Исключительно
отправить: Отправить
дефрагментация: дефрагментация
леви: Леви
дотянуться: дотянуться
транспорт: Транспорт
сёрфинг: Серфинг
исто­рия: Исто­рии
италия: Италии
инвайта: Инвайты
оба: Оба
машинный: Машинное
комитет: Комитет
бэкэнд: бэкэнда
сборка: Сборка
геоинженерия: геоинженерии
мир: Мир
галаксить: галакси
антон: Антон Антону
приобрести: Приобрели Приобретена
риск: Риск
градусник: градусник
бижутерия: бижутерии
продавец: ПРОДАВЕЦ
военнослужащий: военнослужащий
цп: ЦП
пытаться: Пытаться
абсурдность: абсурдность
украинский: Украинский Украинская
васян: Васяна
срк: СРК
пресноводный: Пресноводные
ассоциировать: ассоциировать
тут: Тут
развитие: Развитие
воротить: воротит
гейтс: Гейтсом
аксессуар: аксессуары
снижение: Снижение
московица: Московиц
контролировать: Контролировать
хуавеять: Хуавей
постоянный: Постоянная
крутовый: Крутов
вперемешку: вперемешку
импульсный: Импульсного
докупить: докупить
устранить: Устранить
вини: вини
автостоянка: автостоянками
подозревать: Подозреваю
стрункина: Стрункин
надеяться: Надеюсь
автомашина: автомашины
бедняк: Бедняки
участие: Участие
вотсап: вотсапе
прийтись: Пришлось
пальячать: Пальячи
фарадей: Фарадея
хотя: Хотя
бессмертие: Бессмертие
подписка: Подписка
точнее: Точнее
одноюнитовыя: Одноюнитовый
коршак: Коршаков
пиво: Пиво
судьба: Судьба
рамиль: Рамиль
рейд: Рейд
возрасти: возросшего
выживальщик: выживальщиков
допилить: допилят
бонально: бонально
репозиторий: Репозиторий
дирижабль: дирижабля
начинаться: Начинается
тесный: Тесные
изменить: Изменить
настраивать: Настраиваем
целый: Целых
терапия: Терапия
археология: археологией
насчёт: Насчет
поинтересоваться: Поинтересуйтесь
мониторинг: Мониторинг
варить: варит
вин8: вин8
ремонтопригодность: Ремонтопригодность
живет100: живет100
сервер: Серверы
впн: впн
рис: Рис
вверх: вверх
иначе: Иначе
сбежать: Сбежал
харди: Харди
хайнань: Хайнань
достигнутый: достигнутом
дропать: дропать
вакханалия: вакханалия
аудиокнига: аудиокниг
выключение: выключения
доверенный: доверенными
грм: ГРМ
ия: ИИ
дотошный: дотошных
бодро: бодро
догадка: догадки
гарантироваться: гарантируется
головной: головного
есс: ЕСС есс
фаг: Фаге
потому: Потому
предсказательный: Предсказательная
первичный: Первичная
гипотетически: гипотетически
рай: РАЕ
цельсий: Цельсия
сок: Сок
установка: Установка
англия: Англия
дешеветь: дешевеют дешеветь
эмигрант: Эмигранты
брейк: брейк
видяха: видяху
мышление: Мышление
германия: Германия Германии германии
вражеский: вражеская
многомиллиардный: Многомиллиардные
богатенький: богатеньких
схожий: Схожи
похоже: Похоже
берег: берегу берега
кавиатур: Кавиатуры
газпром: Газпроме
австрия: Австрии
коррекция: Коррекция
ленинградский: Ленинградской
фарранд: Фарранд
вселить: вселило
аромат: ароматов ароматом
дорабатываться: дорабатывается
мелкомягкий: Мелкомягкие
карун: Каруне Каруна
аксик: Аксика
термин: Термин
матрица: Матрица
дерганость: дерганость
доставлять: доставляет
минь: Мини
малахит: Малахит
копн: Копн
шим: ШИМ
всплеск: всплеск
выжить: Выжить выжившего
фина: ФИНАМ
вычисляться: вычисляется
съесть: Съем
квон: Квон
питч: Питчи
дания: Дания
монт: Монте
уч: Уч
вмпомнить: вмпомнил
динамичный: динамичном
марьяна: Марьяна
смс: СМС
держаться: держится
архитектор: архитекторов
бальзам: бальзам
бодный: бодны
рогачево: Рогачева
опыт: Опыт
йм: Йм
положение: Положение
всеобщий: всеобщее
ндс: НДС
беспорядочный: беспорядочные
вовлечий: вовлеч
фио: ФИО
п: П
бред: бред
методолог: Методолог
перевести: Переведем
пекин: Пекин
перспектива: Перспективы
сочетание: Сочетание
джессика: Джессике
адам: Адам
видеонаблюдениедля: видеонаблюдениеДля
бекхайта: Бекхайта
нтс: НТС
медикаментозный: Медикаментозная
повышение: Повышение
уверить: Уверены
балансировка: балансировку
байесовский: байесовские
задаться: Задался
возражение: возражения
цитата: Цитата
дружить: дружащим
производительный: Производительные
сто: СТО
участвовать: Участвовать
полезный: Полезные
дико: дико
астрофизик: астрофизик
венесуэла: Венесуэла
генезис: Генезис
дама: дамы
некоммерческий: Некоммерческие
админский: админских
др: др
виндадлить: виндаДля
вк: вк
болевой: болевые
кирсть: Кирсти
шерон: Шерон
строительство: Строительство
плазма: Плазму
илона: Илона
причём: Причем
доставить: доставили доставлены доставлен доставить
всплывать: всплывает
плис: ПЛИС
пойти: Пойти Пойдем
торонто: Торонто
вконтакте: ВКонтакте
грандиозный: грандиозного
непреодолимый: Непреодолимое
куда: Куда
визуал: визуал
абстракция: абстракции
мировой: Мировые
хэмминг: Хэмминга
короп: Коропов
значение: Значения
роганя: Рогани
телефон: Телефоны
штат: Штатах
михайлов: Михайлов
тачпада: Тачпада
проверка: Проверка
господин: господа
автопроизводитель: автопроизводителей
знание: Знания
составить: Составьте
грузоперевозка: грузоперевозки
любить: Люблю
вциома: ВЦИОМ
выгораниеонтол: выгораниеонтол
живность: живности
парижский: Парижском
изначально: Изначально
газета: газеты
асимметрия: асимметрии
оказаться: Оказалось
врядлить: врядли
близлежащий: близлежащие
еженедельно: еженедельно
контент: Контент
белые: белые
агрегат: агрегата
потеряться: Потерялся
мобильный: Мобильные
аудиотехника: аудиотехника
компьютер: Компьютер
называться: Назывался
мищенко: Мищенко
вглубь: вглубь
виртуализаци: виртуализаци
данныххранилище: данныхХранилища
айлиш: Айлиш
болгария: Болгарии
ала: Ал
казанский: Казанского
метаданные: Метаданные
безалкогольный: безалкогольное
модуль: Модуль
бакс: баксов
датироваться: датируется
возвратный: возвратных
военный: военных
согласно: Согласно
японец: Японцы
антидепрессант: антидепрессантах
гипотетический: гипотетической
бесценный: бесценные
зафиксировать: Зафиксирована
вслух: вслух
ветрогенератор: ветрогенераторы ветрогенераторов
взвинтить: взвинтившая
учиться: Учимся
взаимоувязанный: взаимоувязанных
поскольку: Поскольку
институт: Институтом
киткат: Киткате
глотка: глоток
доводиться: доводилось
разбиение: Разбиение
дистанционно: дистанционно
русенко: Русенко
группироваться: группируется
нормально: Нормально
бд: БД
поведенческий: Поведенческие
заинтересоваться: Заинтересовался
воскликнуть: воскликнут
далеко: далеко
формироваться: Формируется
ли: Ли
публикация: Публикации
спутниковый: Спутниковый
видеовыход: видеовыход
данилов: Данилов
ооп: ООП
шутка: Шутка
дикарь: дикарь
андриессный: Андриессен
апстрим: апстрим
похожий: Похожая Похожие
забавно: Забавно
бурно: бурно
турaйя: Турaйя
харьков: Харькова
досуг: досуге
многие: Многие
архаичный: архаичный
считаться: Считается
грядеш: грядеши
доперевести: доперевести
ширина: Ширина
достойно: достойно
разумеется: Разумеется
браслет: браслет
пбайт: Пбайт
слить: СОЛЬЮТ
убедить: Убеждена
вспомогательный: вспомогательного вспомогательных
космос: Космос
клон: Клон
альтруизм: альтруизм
масштабировать: Масштабируемые
тоновый: Тоновый
открывать: Открываем
вхождение: вхождение
предоставление: Предоставление
пкпохоже: ПКПохоже
вскоре: вскоре
неуверенный: Неуверенное
блобый: блобы
биосигнал: биосигналы
пусть: Пусть
вносить: вносить
обновить: Обновить
диалоговый: диалогового
тв: ТВ
козлов: Козлова
светлов: Светлов
воспитание: воспитанию
алкоголизм: алкоголизм
адс: АДС
систематический: Систематическая
даром: даром
автомобилист: автомобилиста
стик: Стики
затем: Затем
пространственный: Пространственные
привет: Привет
тоже: Тоже
дефолтнай: дефолтная
автокада: автокаде
авиалайнер: авиалайнеров
демонтировать: демонтированы
манипулятор: Манипулятором
томас: Томас
шеремьев: Шеремьевой
малявино: Малявина
бывший: бывший
назад: Назад
демонстрироваться: демонстрируется
билли: Билли
конвеять: Конвей
твиттер: Твиттер
колдуэлла: Колдуэлл
градация: градации
пирсиг: Пирсига
райнхардт: Райнхардт
визг: визга
правильный: Правильные
короче: Короче
наверное: Наверное
хранитель: Хранители
отключить: Отключишь
хаус: Хаус
истощать: Истощающая
пока: Пока
раздавить: Раздавив
собственно: Собственно
снг: СНГ
комп: Комп
тайлера: Тайлер
авторски: авторски
реб: Реб
конечный: Конечная
отдых: Отдых
войско: войск
гуру: гуру
текстовый: Текстовый
мощный: Мощный
быстро: быстро
изображение: Изображения
добротный: добротный
вокруг: вокруг
гербер: герберы
доза: доза
построить: Построен
данныхвысоконагруженный: данныхВысоконагруженные
рутуба: Рутуб
ппс: ППС
петля: Петли
функционально: Функционально
дактил: Дактила
дешман: дешман
вебсёрфинг: вебсерфинга
калькулятор: Калькулятор
самсунг: Самсунг Самсунга
дёшево: дешево
прошивкаandroidromкастомандроид: Прошивкаandroidromкастомандроид
мингалимов: Мингалимова
хосейн: Хосейн
герцеговина: Герцеговина
балансировщик: балансировщиков
персонализировать: Персонализированная
технотекст: Технотекст
калман: Калмана
загрузочный: Загрузочные
вследствие: вследствие
кевин: Кевин
рекомендация: Рекомендации
ажнюк: Ажнюк
кристина: Кристины
декларативненький: декларативненько
бесполезность: бесполезности
газ: газов
вой: вой
криптодиван: Криптодиваны
слово: Слова
новосиб: Новосибе
рефакторинг: Рефакторинг
робототехника: Робототехника
нит: НИТУ
гоняться: гонялись
выводиться: выводится
вводиться: вводится
воробей: воробьям
регион: Регионы
грамм: грамм
